wjdrkdlsaor	wjdrEkdlqsaor
wkqwlrhkdrh	wfkqwlrhdkdrh
whtpqneka	whdtpqnveka
dhglfudbgo	dhglfudbgzo
qhfnspdh	qRchfnspdh
wjtrkfrlacl	wjtrkafrlacl
tkatjdghkwo	ztkatjdghkwo
wkehdckrhddjqguqehdwhgkq	wkehdckrhddjqguqehdgwhgkq
djqthemfdlsmf	ddjqthvemfdlsmf
flghrhksrhkd	flgxhrhksrhkEd
whdgkqqhrwlghlrhks	whdgkqqhrwlghlrhkTs
rnralsdlaeo	rnralsdlsaeo
qkrekfskan	qkrdekfsdkan
dmaqksrPdir	dmaqksrPdEdir
qksdlghlckd	qWkssdlghlckd
rkwkdrlrks	rxkwkdtrlrks
alswnxntk	alswnxQntk
gkqslekchlwhd	Egkrqslekchlwhd
rlawngusrlwk	rlaRwngusrlwk
gkfkrqkdgid	ggkfrkrqkdgid
dbtkdwmdwkgn	dtbtkdwmdwkrgn
xhdghksodur	xhdghkrsodur
ghksdbfwjdcor	ghkxsdbfwjdgcor
tkavhxpzm	tkagTvhxpzm
ahxjtmakxm	ahxjtmwakxm
tltmxparkaflguqghl	tltmxparkafWlguqghl
Eoansdpgodhl	Eovangsdpgodhl
wltlreoruf	wltlreorduf
qlcjfrmathrwn	qlcajfrmQathrwn
xhdwmddmlgkr	xhdwmddRmlgkr
rldjqqldyd	rrfldjqqldyd
ehtksdjqan	ehtksdjqgan
durtlrjxahtmq	durtlrjxahtvmq
fhalddlfks	fhalWddlQfks
qkddjtneks	qkddjRtneks
vustjdrnrwkd	RvustQjdrnrwkd
anffiddldb	anfvfiddldEb
gjrktlscjd	tgjrktQlscjd
rhdtldkqls	rdhdtldkqls
wjsrnrdjsfhs	wjtsrnrdjsfhs
tjehwndrnr	tjehtwndrnr
cptlsdjqan	cptlsrdjqan
chqheksrP	chqhgeksrP
rlwlrjstjf	rlwrlrjstzjf
qntlagodhkTdm	qnqtslagodhkTdm
dhlghkdPrma	dhlrwghkdPrma
shtnpdlwls	shtnpdlwQls
rkdgkanfwlf	rkdgkeanfwlf
gksrnrduwkvmfhrhfvmguqghl	gksrnwrduwkvmrfhrhfvmguqghl
fmfEjqkecl	fmfERsjqkecl
dlstkqorud	dlQstkqorud
sofurksmsemd	sofurksvmsemd
wkdsotprbs	wksdsotprbs
rmqducprProvus	rmqducprPzrovus
akzptdlsdpdlqmffj	akzptdlsdpdlqmreffj
qkseodufhs	qksdeodufhs
dmfhdlfrhks	dmfhdslfrhks
eotkdvnaahr	eotkdvnaTavhr
qntksrnejrwn	qEntksrcnejrwn
dmlghrqnqns	dmlfghrqnqns
tntlqsusrks	tntlqsxusrks
qnekddldlr	qnezkdcdldlr
tksdjqrltnf	rtksedjqrltnf
rltnfgurtlstpsxj	rltdnfgurtlstpsxj
eoehdquddnjs	eovehdqeuddnjs
wjdqhwnrnjs	wwjdqhwndrnjs
vhrxkswpwh	vhTrxkswpwh
vhrqkfwlrwjs	vhrqekfwlrwjs
rytnemfdmlshf	rytnemfdmlgshf
shsusrnjsdlrqhgh	shsusrEnjsdlrqhgEh
toddjqdmfRnfurkf	toddjqfdrmfRnfurkf
vjsemrmfnq	vjsemrmfnvq
akdaudrlrks	akRdaudrlrkTs
wkrmaskwwka	wkremasEkwwka
rmsangkejsghltk	rmsangkejseghltk
dlsxjsptqodzm	dlsxjsptqeodzm
dlfqnqksqkf	dlfqnqkasqkf
rnstkqjqdnjs	rRnstkqjRqdnjs
xkwlrltmxks	xxkwTlrltmxks
wjsekdfltkdlxmfghf	wxjsekdfltkdlxmfEghf
qnvnarldjq	qnvnarldjzq
dlTsmstlso	dlTsmstleso
rlsmdeogkrwkd	rlsWvmdeogkrwkd
rhksrhkddnldnjs	rhksrhkddsnlvdnjs
wpgksgoddnl	dwpgksgoddznl
rjatordlghkfrl	rjatordlghkfrxl
vkfrhdskswkd	vkfrhdskswcxkd
xhdwkddlswk	Exhdwkddrlswk
cowjasodur	tcowjRasodur
gkqdml29qn	gkqdml29qtn
wjsdjwkqdl	wgjsdjwkwqdl
dlfmfqhrh	dldfmfqhrh
skantwhrkr	sgkantwhrkr
govlqjtm	gTovlqjtm
tjswlsrmadbdrlqjqdmfhanwkdgk	tjswlsdrmadbdrlqjqdmfWhanwkdgk
dbfjqwnddkd	QWdbfjqwnddkd
zofhffkdlskwn	zofEhfefkdlskwn
fpwjwnxorrhdrks	fpwjwnxorrhzdrks
ruddudgurtlsdpswls	ruddudgQurtlsdpswls
rkrwhddkswjs	rkrwhgddkswjs
rydbrqhsqn	rydxbrqhsqn
rjtdmfhqhsms	rjtdmfhqfhsms
aorwngkswks	gaorgwngkswks
rydbrgbwlr	rydbrgbweler
dldjrkftndlT	dlqdjrkftndlT
tkatjdwjswkelwlxjf	tkatjdwjswkelwlxEjf
tkcothrkr	tkcothdrkr
roffjfldptjduffls	roffjfldptjdufflws
rlawptkfy	rlawptkfzy
dmfdmlalgk	dmftdmlalgk
wlansdlstlrtltmxpa	wlansdlstlQrtltvmxpa
qkddjwjsfir	qkddejwjsfair
ghkrwjdgoshg	xghkrwjdgoschg
guswltkdghkd	guswltkdghkQd
rudwodrhkwjd	rudwodrghkwjrd
skxkskTdmaudlsms	skxkskTsdmaeudlsms
duwkxkrrn	duwkxekrErn
ekszkswltn	eRkszkswxltn
tkackdvmfkwkqlfeldqptmxm	tkQackdvmfkwkqflfeldqptmxm
rhltksrnscjd	rhltktsrnsQcjd
rhdrmqworo	rhEdErmqworo
ehzbajsxm	ehzbajsxQm
dptjwkwn	dWptsjwkwn
ansjwusofls	ansjwuseofls
dugodrPdir	wEdugodrPdir
emfdjtjsshgn	emfdjtjssvQhgn
cjsehrywnddkd	gcjsehrywnddkd
eofbrghldeks	eofbrghlwdeks
dnfltkwnwhgkq	cdrnfltkwnwhgkq
qnrgkscpwp	qnrgkscpcwqp
wmdtkswkrdjq	wmdtkswkzxrdjq
qustlsgksmsepgksahrt	qWustlsgksdmsepgksahrt
tkdjqwjsfirdm	ftkdjqwjsfirdm
Ektjdirtp	EkztjdEirtp
xhdghktltmxpa	xhdghktlvtmxpa
gkswkrjawjdsmdfur	gkswkrjawjdsmgdfur
dnthddPtnf	dtnthddPtdnf
wlrwjqwhekf	wlsrwjqwheskf
tmdflfmfrjenjTtmqsl	tmdflfmfTrjenjTtgmqsl
elwlxjfaleldjekswl	elwlxjzfaleldjekswl
dlstkarhdtk	dlstqkarhdtk
rhksflqnsdi	grhkssflqnsdi
wjdekdaudqn	wjdeEkdaudqn
ehrrkadPqkd	ehsrrkgadPqkd
duwkqorn	gduwkgqorn
rlaTlrkdl	rleaTlrkdl
rhkrcndgheowjstjqn	rhkrcndgwheowjstjqn
wpwkrgoqntksdktldks	wvpwkrgoqntksdktldks
dlTsmsrnaowkrma	dlTsmtsrnaowkrma
vudrbssowo	vuEdrbssowo
worhwktks	worhwktkxs
guseovpdlsxm	guwseovpdlsxm
ruddusaneo	ruddsusaneo
rudrPtkdxo	rudrPtkdsxxo
vusdlthro	vusdltzhro
wlqnstmdhkvmanswp	wlqnstRmdhkvmganswp
rhrmqwpvna	rEhrmqcwpvna
enlttlaqnwhr	ewnlttlaqnwhr
sbtmtkqjqwpwjd	sbatmtkqjqwpwjrd
wjdrmawhwjsan	wjdrmawhEwjsan
fkdntbvp	fkdqnTtbvp
rkftnfhrrjtpwl	rdkftnfhrrjtepwl
dkfxkflan	dskfWxkflan
dkfmwpsxh	dkfmwcvpsxh
wjsskashddjq	wjsskatshddjq
qncofmftmdrP	qncofxmftmdrP
ansghkdudtkd	axnsgQhkdudtkd
xkgoddlcp	xkgodEdlcp
eodhldltk	ceodhldltk
rhrordjqcp	rfhrordjqEcp
ekfdhfmarmrwkd	ekfdhfmarmrfwkd
fhcjscjsgl	fzhcjscjsgxl
dlfthsdlqnwhrgowls	dlfthsRdlqnwhrgowlRs
wnxordmstjdnf	wfnxordmstjednf
rmsrjfhtka	Wrmsrjtfhtka
dnswjsausgj	dnswjTdsausgj
wmdwkfmfdnlgo	wmdwgkfmfdnlgo
dhqxhaowlr	dhfqxhaowlr
dnlrlfmfakwrh	dgnQlrlfmfakwrh
alsthrakdmfcnwlswnsql	alsthrakdtmfcnawlswnsql
wjsrnrduddjdndqus	wjwsrnrduddjdndqus
emfdprpdidqls	emfdprpdiddqls
skadnjswldur	skadnjxsswldur
dlTsmsfhdif	dlTsmesfhdizf
rlaTlrkwnwkd	rlqWaTlrkwnwkd
ckwdkrksmsrhkwjd	ckwdkrksmsrhckwdjd
dPtksrbah	dPgtksrbah
durqoduftkdxorkrkf	durqoduxftkdrxorkrkf
xnwkwjrrma	xnQwkwjrrma
tmzkdnxm	tmzQkdanxm
rkdwhdrnrlwk	rzkdwqhdrnrlwk
eowjsguqwjd	eowjsguqwwjd
tjdvnawjsekf	tjdvnawejsqekf
ckddjqchrl	ckddjWqfchrl
tkawjdwndn	tkawjdwndwn
tlsehdrhddjq	tlsehdrhddTjq
qhrrnqldyd	qhrQrnqldeyd
gkdlxprdmswnrkdkswjd	gkdlxprdmswxwnrkdkswjd
dnjtldxjseogkr	dRnjQtldxjseogkr
qhghwhcl	qhgehwhwcl
zhsptdnjfem	zhsptdcnjfem
rmarkdwpghk	rmaErkdwpghk
dlaskdlfqhsqntjf	dlaskdlfqhfsqntejf
dbqordbTl	dbqdordbTl
tkdydgodh	tkvdzydgodh
dbaudgodks	dbxtaudgodks
gudtkdjqxlawkd	gudtkdjqxlqawkd
gmlfhdofkr	gmlfhdofkQr
tpdlqtpcnfruftks	tpzxdlqtpcnfruftks
dnfuroqhd	dnfxuroqhd
ehdcndgkch	ehdwcndgkTch
wnddyalsthr	wnddyalstcghr
dPwjddlrks	dPwjddrlrks
tkdghkddmsdlemf	tkdghkddmEsdlemf
rmflsfkqpf	rmflsRfkqpf
dnwlswhdgkqrjstjf	dnwlswhdgkdqrjstjf
fmfdlxkfgkrj	fmfwdlxakfgkrj
wjdtkdcnfrms	fwjdtkdcnfrems
wktlsrkadmfrkwrh	wktdlsrkadmfrkwrrh
cjdsusdlsrn	cjdQsusdlstrn
thrduvksaogk	thrduvksaQtogk
dhthdrnrwpqkdldhgkrtnfeoghl	dhthdrnwrwpqkRdldhgkrtnfeoghl
ckfidwmdwjd	ckfidwmdwqjd
tjsrudandur	trejsrudandur
eoanstlwkd	eoanstqlwkd
xodjskwlswntkqja	xodjskxwlswntkqja
wjdqnwhdgkq	wtjdqnwhdgkq
ckdflqwkans	cEkdflaqwkans
rnrwpguqfurdmsgod	rnrwpguqfurdmsggod
dnfldmsgodruddud	dnfldmsgodruddWTud
dhgn3tl20qns	dhgn3tl20dqns
tprP22dnl	tprPr22dnl
eoaksdlfqhs	eoaksdlfzqEhs
qhrhksxhfhrgo	qhrhksxhfhrrgo
wlsksgoqpdlwlddbslqjtldkemduwk	wlsksgoqpdlwlddbslqjtldzkemduwk
wkdrlxorqodnsthdrPdir	wkdrlxorqodrnsthdrPdir
wjsqnrehghl	wjWsqnrTehghl
wnalsvusdlrtltjf	wnWalsvusdlrtltjf
aleldjvmffpdldj9	aleldjzvmffpdldj9
tlsdydqlfeld	tlsdydeqlfeled
tlsdlfqhstksdjq	tlsdlfqhstrksdfjq
xotjddlshxprdnjfem	xotjddlshxprdnejfem
qhrhksckdrhghkwo	qhrhksctkdrhghkwo
rhdrhfmfghkrdlsgksenl	rhdrhfmfghkrvdlsgksenl
dksgrhdlTdmsk	dzkszgrhdlTdmsk
ekdlsoalr	ewkdlsoalr
rlaehtnfTldlswl	rlawehtnfTldlswl
qkfrnfrhkwjd	qkfrenfarhkwjd
rkwksmsrjt	rkwksmscrjt
threhqkdtn	tthrehqkdtn
dlswowjsfir	dlswowttjsfir
rnjsdlrgidtkd	rnjsdlrgaidtkad
tlsrhksehdeo	tlsrhksvehdeo
dlTsmsrhsrud	dlTrsmsrhsrud
tltmxpawpwh	twlztmxpawpwh
qordjqthffntus	qsordjqthffntus
andyddPtnf	avndyddPtnf
vkfkgrpqhdl	qvkfkgrpqhdl
gksmswndrnrcp	gktsmswndWrnrcp
qnfrytktkd	qnrfryttktkd
qldydrnwh	qldyedrnwWh
wkdtpwjsghks	wkzdtpwjsEghks
wkdtnwldur	wckQdtnwldur
thfrhqkdldhapelzkf	thfrhqkdldchapelzkf
tlffurehrkwrh	tlffwurehrkwrh
dmsgodehdrudwlwja	dmsgoddehdrudwlwja
thskandhkqks	thskandhzkqkrs
cnscjsqnfryqkdthd	cnscjsqnfcryqkdthd
xhdrPwkrdjq	xhdrPwgkrdjq
qnfqjqdjdjqgoddnl	qnEfqqjqdjdjqgoddnl
qotkdcordlaqhgja	qotkdwcoardlaqhgja
eoqnrcjqqh	eoqnrxcjqqh
emddmfhghksruddhdua	emddmfhgThksrcuddhdua
ekffjtkdtmd	ekrffjtkdtmd
gkcjswjdghk	gkcjswjderghk
wkawjdtkdyd	wkaewjdtkrdyd
tjsrjdlgn	tjxsrcjdlgn
rnwhdjqan	rnwhdcjqan
djrwlcnsgid	djrwlcWnszgid
dlfdjsqksrn	edlfRdjsqksrn
thsusemfdmlaowkdwkdth	thsusemfdmlaQowkdwekdth
gkqnrlrhks	gkqdnrlrhks
gksrnrrnrdkrguqghl	wgksrnrrWnrdkrguqghl
wjdrlrhdco	wjddrslrhdco
smsguseotkdtjs	smsguseotkdtcWjs
wpqkdrhdtk	wRpsqkdrhdtk
aorudajsl	aowerudajsl
ekatndlwjs	ekatndlWwjs
whdahremfrhkwn	whdahremgfrhkwn
zkemeocnf	tzkemefocnf
tnfuqghkfehd	tnfuqghEkfehd
cnldjqwnsql	cnzzldjqwnsql
endkshdhk	endWktshdhk
zkemruadyd	zkemruqRadyd
emfdmsekth	emfdmserkth
dusqkddmldnjs	dusqkdRdmldnjs
qkfptdmfchcjdgo	qTkfptdmfcwhcjdgo
whdjqdjwkd	whdjqwdjwRkd
wmdtldirqkf	wmdtldirqxkzf
tlalsgkrry	tlWalsgkrry
wkehdwnans	wkehgdwnans
dhvltmxpf4cmd401gh	dhvltmxEpf4cmd401gh
rudwprhksrP	rudwtprhksrP
tjehtjdwkd	tjeehtjdwRkd
wlwornjswjdtkdghldml	wlwornjswjdtkdghfldml
alwmghvkdlsostufrmfnq	alwmdghvvkdlsostufrmfnq
rksghdjqan	grksghdjqan
apdlfzmffjq	apdlfwzmffjq
rhkddurthrkr	rhkdfdurwthrkr
shddirwpvna	sRhddirwEpvna
tkdptjchltjdghd	tkdptjchltjdghsd
duftkrlsua	dzuftkvrlsua
wldurquddnjs	wldurrquddnjs
dhkghwkdfyd	dchkghwkdfyd
aorkrwldnjs	aTorskrwldnjs
xhddlfdnsehd	xhddlfdgnsehtd
diekddmldnjs	diekddmvldznjs
cjflqkdqjq	cjflrqkdqjq
aneksxnrl	rganeksxnrl
dptjsmswjdtkd	ddptjsmswjdTtkd
rudrlrhksfka	rudrlRrhksfka
gksrufprmfla	gksrufprmflta
anfrkdusehd	anfrkdussehdd
ekaqodOrl	ekaqtodOrl
wpwnehdutls	wpwneehduatls
vhrfurtjzmf	vhrfurdtzjzmf
todrhrfldkv	todrhrfcldkvv
eoaksrhfvmtkdvna	eoaksrhfTvmtkdvna
gksmlqkfka	gksmlqkfkxa
dlckwdkTdj	sdlckwzdkTdj
tnwldkrghk	tenwldckrghk
rntjdehlscpwjd	vrntjdehlwscpwjd
vlffmagudxo	vlffmagudsxo
dhlrnrtjstn	dhlrnzrtjstn
gksmsepehalvlfgks	gzksmsepehalvlfgks
rkddnjswldur	qrkddnjswldur
altnftprP	altnwftprP
rhdgkrtksdjqekswl	rhdgkrtksdjqeksfwl
vowjsxntn	vowjsxnqtn
todtksqkswkd	todtkQsqkswkd
zjstjfxjsem	zjstjfxTjsewm
rltnfguqfur	rltndfrguqfur
dpsdptmrjscnrtjfrP	dpfsdptmrjscnrtjfrP
skdkrkrm	skdkrekrm
tmxlrmflcm	xtmxlrwmflcm
skatjdeksdnjs	skaQtjdeksdnjs
voddlclrl	dvoddlcdlrl
ryxhdrhksfusqjqrbdnlqks	ryxhdrhksQfusqjqrbdnlqcks
eoxhdfudrhdqhtntjr	eoxhdfuqdrhdqhtntjr
wkwjsrjahf	wkwwWjsrjahf
dlsfurdmfcjftn	dlfsfurdmfecjftn
wnrkstlsgh	wnrxkstslsgh
toakdmfrmarhdkv	toakdmfrmarhdksv
eostmeoghl	eoestmeoghl
tjdrhkrhksfus	tjdrhkdrhksdfus
dlfqntmdth	dlsfqntmdth
dnpdjwjdvnatkdydahqja	dnpdjwjdvnatkdydwahqja
dpguqwhgksek	dpguQqwQhgksek
qlTlfkdls	qlTTflfkdls
shddjqrlqksrhdtk	shdwdjqrlqksrhdtk
dusrmrwpwhwlr	dusrmrwpwhwzlr
wntlrdlsjan	awntlrdlsjvan
tjddnjswnxorgkfqn	tQjddnjswnxorgkfqn
cprufrmador	acprufrwmador
duaksrkak	aduaksrzkak
tkagoeofla	tkagogeofEla
qntksansghkghlrhks	fqrntksansghkghlrhks
cjstkdnsehd	cvjstkdnsehd
dksgsmsekrnrsotnvlfwjstjdcjf	dksgswmsekrnrsotnvlfwjstwjdcjf
qhdlsmsdlehdxhdtls	qhdlsmsdlehdaxhdtls
xmfpszmsms	xmxfpszamsms
qicptmffkvm	gcqicptmffkvm
wldur18ro	wldEur18ro
zhtmekrtlwkdemdfhr	zhtmekrtlwkdemdfhTr
eoghlwlrgn	eoghlwlrgvn
wlqwndrkafl	wTlqwndrkafl
rudrlrkRmxsks	rudrlrkRmxzsks
dmsgodgkqqud	dmsagodgkqqud
Rmxekgsmsrmrht	Rmxekgsdmsrmrhct
tkdjqdmfwns	takdtjqdmfwns
rmfjgrpehl	rmfjgrapehl
rnrsodbcl	rnrqsodbcl
tngoakdmf	tngoakdrmf
dmfvhgkago	dmfvhgvkago
ghkswkrkatl	ghkqswWkrkatl
rhrmqqlffk	rhqrmxqqlffk
tmvhcmakzpxlddjq	wtmvhcmakszpxlddjq
tkatksxorwl	stkatksxorWwl
eorntjqn	eornttjqn
dlTeksmswjsakddlqsl	dlTeksmswjsakddlWqsl
dlfqntlfldjf	dlQfqntlflrdjf
xldlstbdjfjstm	xldldstbdjfjstm
alrnrdusqkd	alcrnrdWusqkd
rudwpruddud	srudwptruddud
qjqdnjsrudao	qjqdnjsrvudao
dmlskrvhrcnrth	dmlsrkrvhrcnxrth
qhdksanswp	qehdksanswp
zpdldlTl	zpxdldlTl
gpwlvjsemtkdjq	gpwlvsjsemtkdjq
ektksqjqdlseoflwja	ektkstqjqdlseoflgwja
dusthrgkfkr	Tdfusthrgkfkr
dhlqntkdghkd	dqhlqntkdgghkd
eogoddPchs	eogoddPchgs
wlaudrudwod	wlaudrucdwod
cornjstltmxpa	xcornjstltmxpa
gudxodlamfhwoan	sgudxodlamfhwoan
skgPdbsTl	skTgPdbvsTl
wldnjsduqn	wlfdnjsduqRn
dnjftmxmflwjsjf	denjftmxmflwjsjf
gkstoarnrdjwjsansrydbr	gkstdoarnErdjwjsansrydbr
eltmzjqjfltkdldjstmcosjf	eltmqzjqjfltkdldjstmcosjcf
emfdmlrkrquf	emfdmlrkcrquqf
wkrlwntlrcnlemrtlsxkrrPdir	wkrlwntlrcnlemErtlsxkrrWPdir
rpdlatmvkt	rpdlatmvkgt
djqanvmfhtptm	djqanvmfhtaptm
cjsdjrdnjssmfdjskT	cjsdjrdnjssmfdjstkT
rmarlfufdnjswn	rmarlfTufqdnjswn
qkdthdtjqltm	qEkdtthdtjqltm
dhlghksdmsgodemd	qdhlRghksdmsgodemd
ghkswjrghkanf	ghksxwjrgzhkanf
wowjdthstlf	wowqjdthstlf
wpwnvoszhfldkqhffld	wpwnvoszhfladkqhffld
cprkawltn	ecprkawltn
skwdkwlrhqus	skwedekwlrhqus
rkdwpwldtnqkddks	rkdwpwldtqnqkddks
tjadbthworltnfroqkf	tjasdbthworltnfrodqkf
dhkswjsxhdgkq	dhkswjqsxhdgkq
tjryqlfeld	tjryrqlfeld
tmfjdnsrk	tmfWjdnsrk
xnwkwjdcor	txnwWkwjdcor
qotjejrkdska	qotjezjrkdska
rhfemstbwm	rhzfemastbwm
gjdydgodkRkqrp	gjdydgozwdkRkqrp
rkwjdvhrfurcnqkd	rkwjdvhrcgfurcnqkd
gkrtnfghkfehd	gkrtnfgWRhkfehd
djflsayfmf	djfslsayfmf
akdlslcl	akdlselcql
qnfvusEoans	qRnfvuvsEoans
wjstprjfo	wjstprjfzo
rhkeoakdtkd	rhkeeoakdtkd
wkcprltnf	wkctprltEnf
rhqkftodgn	TrhqkftoQdgn
xhdtlsthffntus	xxhzdtlsthffntus
rndlqqneka	rndlqqaneka
dudghkepqnl	dudghskepqnl
gkdntmrkarbf	Wgkdntmrkarbf
wldurrltnfgurtls	wldurrltnfsguzrtls
tjswjsghktk	tjswjsghkrstk
skaausvkcnfthwkd	skaausxdvkcnfthwkd
tjsrjqkdwl	tEjsrjqkdwl
dltmqjrm	dfltmqjrm
zkemqnfqjq	zkegxmqnfqjq
duddjqdnlgja	dTvuddjqdnlgja
wjdtlaghkghf	wjdtlawwghkghf
shddjqrltnf	sthddjqrltsnf
clagogksmsrjt	clagogkssmsrjt
rhfvmvjxld	rhfvmvjxWgld
skfksglruftmd	skQfksglruftmd
ehrehqkranfrhks	ehrehqkranvfrhks
ghkfehdeksdnl	ghkfehdektsdnl
tjdnfdusxhd	tjdnfdusxhfd
ryeochdwkd	rygeochdwkd
rjatkghkfehd	rjadtkghkfcehd
qnekagodirPdir	qnekagodirPditr
qkrmekemdmf	qkrmefkemdmf
dlemsEkfdl	dlemQsEkfdl
zmfpcmaj	czmfpcsmaj
gkftnehdlTek	gkftnehvdlxTek
thaormadbdwlwja	thaormadbsdwlwtja
gksekrhtjrgkr	gkQseekrhtjrgkr
dkvdptjwlrwkd	dkvdprtjwlrwkd
tjddlstkdlxm	tjddlstrkdalxm
akdmfvPtn	akdmfzvPtn
eoqnfrnrrktksdjqekswl	eoqnfrnrrdktksdjqekswl
ckdlfhapekf	ckdlfhapeekf
sjanzjtj	sQjanzjtgj
wjdqneowjscjdtk	wjdqqneowjscjdtk
tnfkrdustjf	tnfTkrcdustjf
ghdcjsrnrehdbwlrhksfltkanth	ghdcjsrnTrehdbwelrhksfltkanth
Tkddydghkwo	Tkddydghkwfo
wpwngotn	wpxfwngotn
gksrnrwlflwjdqh	gksrnrwElflwjdqh
xkdns434gh	xfkdns434gh
woqjf2tp	woqvjf2tp
wjdqnrhksfy	wjdqvnrhksfy
dlTdmaueksansaptlwltjqltm	dlTdmaueksansaptlwltjqltTm
rnehrrPdir	zrnewhrrPdir
tjdnfwldurqhsqn	tjdnffwldurqhsqn
wlrtlgkfEo	QwlrtlzgkfEo
rkaehrrlrhks	rRkaehrrlrhks
vndanfansghk	Tvndanfansghk
dkdlwmghfeldtmdl	dkdlgwmghfeldtmdl
wktkwjstl	wktkwTjstl
tldptjsmstnsckf	tldptEjsmstnsckf
djqrmfpdlem	djqrfmfpdlem
didgustmdgksrnrrhkgkr	didgusTtmdgksrgnrrhkgkr
dlscjstkdfbr	dlsRcjstkdfbr
alrnrskaqn	alrnrsktaqn
wlsrudduwnd	welsrudduwnxd
gudtjdehlaustjdlxmfWo	gudtjdehlaudstjdlxmftWo
qkesmsrhkdwndmsgod	qkeesmsrhkdrwndmsgod
wndeogkstk	wnrdeogksctk
ehekfgksmssi	ehekfgksmrssi
dlTsmsqPstudnwl	drlaTsmsqPstudnwl
wncprnrals	wncprnrqals
wpqlwlqthtm	wpqlwWlqtrhtm
wjfclsgkstk	wjfclsgkTstk
tprPrlfhrdmfThe	tprPrlfhzTrdmfThe
wkrkvnawlf	ewkrgkvnawlf
tjfvjtmvmflddpahdls	tjfqvjtmvmqflddpahdls
dbdmlwhdahr	dbdmlwhdahcr
dkskarjstjfeovy	dkskaErjstvjfeovy
dmfdnsdudgks	dmfdnsdudgTkxs
qoraktkeks	qoraktTkeks
tlsrbemdfhrwhdahr	tlsrbexmdfhrwhdahr
wkdusghksrud	wkTdusghksrud
wlwlxhdtls	wRlwlxhdRtls
gksqkdquddnjs	gekssqkdquddnjs
ajswjqkdwltltjf	ajswjqkdawltltjf
alsdmlthql	alsddmlthdql
dlstidldixm	dlsteidlTdixm
cjqqhdnltjd	cjqqhdnxltjd
anfrkqusehdqns	anfrkwqdusehdqns
rkdghekdnstlffur	rkdghekdnstlfwfeur
tkdghwkrdyd	tskdghwkrdyd
dlemfwnqus	dlemfwqnqqus
dhkchlrudfid	gdhkchlrudfid
rPwhkdlcptjqltm	rPrwhkdlcptjqltm
dhkfydtksdptjtlfwhd	dhkfydctksdgptjtlfwhd
xovudghkdnl	cxovudghkdnl
wowjdrudwpdnldnjs	wowjdrudwpdnldnrEjs
xmrfPdlqgkr	xdmrfPdlqgkr
rkatlvudrkrPghlr	rkatlvudrtkrPghclr
rnrduddlfrks	rnrduddlfrkQs
cndcjdskaeh	cnwdcjdskaeh
rhdwjdrjfo	rhgdwjdrjvfo
xntlswktkf	Txntlswktkf
thwodjqcp	tQhwodjqcp
duddnjfwldur	duddnjfRwlEdur
zhfldkajcjs	zhfldkqajcjs
wldhzmfhs	wTldhzmfhs
fkdpffldks	fQkzdpffldks
rnrflqwjswkzjavbxj	rWsnrflqwjswkzjavbxj
fosemtkrks	fosemtkWrvks
rhdgkddnsdud	rhdgkddnsduzd
rkdyvmfhrmfoa	rkdyvamfhrmfoa
tkrurrudrl	txkrurrudwrl
Tkfthqlrkath	Tkqfthqlrkath
todtksqnsdi	todtgksqRnsdi
wjatnrudwod	wjatnrudrwod
vmfkselsk	vmdfkselsk
wlsksgoakf	wlsksdgoakf
rhksrhkdruddud	rhksrhkdruddufd
cpqnfdlarma	cpqnfdlarxsma
dusrmatkdvna	dusrmatqkdvna
rudwodrurghk	rudwodrurqghk
rhthrcjfehrhdeks	rhthrcjfehrhdqeks
rhdtmqrPghlr	rhdqtmqrPghlr
dbxhdwjsansdlsfur	dbxhdwjsansdlsEfur
elwlxjfdudtkdwjwkd	elwlxsjfdudtkdwjwkd
whtjseoqnthr	whtjseoqntThr
todahflcm	tRodahfclcm
rnrxhdldydrPghlrqusrud	rnrxhdldtgydrPghlrqusrud
vywjddmsahen	vywcjddmsahen
rkqkdvldpfmrkfmepd	grkqkdvldpfmrTkfmepd
cjsdnjsWkfl	cfjsdnjsWkfl
ekdidgkstkfPfmf	ekdidgkstkEfPfmf
shgrhxhfhsgk	sEhgrhxhfhsgk
ckrhksdmsrmfj	ckrhksdmsvrmfj
wlqgodrhkwjd	swlqgeodrhkwjd
dkaghgoehr	dkaQghgoehr
wkdausdmsehdanf	wkdausdmsehdanvf
qotkdtlscjd	qotkdtlqscjd
wpwnehdduwnd	wpdwnehdEduwnd
aleldjrldjq	xalreldjrldjq
cjdghkdgodyddhkdgmagid	dcjdghkdgodyddhkdggmagid
dldjeoghl	dRldjeoghl
dmlwndrjfltbt	dmlEwndrjflftbt
gnqhwldur	gnqhwlsdur
gkseksmsdOrl	gksezksmsdOrl
tmvptuffltmxm	tmvptuffltemaxm
qoekdvmffjtm	qqoekdvmffEjtm
wlausehdaus	wlaqausehdaus
dbqnqkqdbqn	qdbqnqkqdbqn
wpwnwndansghxpf	wpwnwndansghxpdf
dufjtdltj	dvufjtdltj
gkfkrgksmsemd	gkfkrgksdmseqmd
doqmsbdml	doqmsvbdml
gosemalrtj	wgosemalrdtj
rhkdrhtndlreogoddjqwk	rhkdrhtndlreogoddjqqwRk
xmrtnwjfehguadml	xmrtnwjfehTguadml
tkausgkfdls	tkausgqkfdls
tmakxmzkemrhksfl	tmaRtkxmzkemrhksfl
wldnjsdmfgown	wlednjsdmfgogwn
qkrmekem	qkrmEekxem
wktjrhals	wkQtjrhqals
whrjsdmfaksg	zcwhrjsdmfaksg
rkrndpdlfm	rkrTndpdlfm
rmfjsktlfwp	rmfjsktlTfwp
rhksflwjsakd	rhksflwjtsakd
tpfptkdlxm	tpfcptkdlqxm
tmtmfhdnjsclr	tmtmfahdnjsclr
anrlwpgksguqwjd	anrlwpgksTguqwjd
dlfrkadmfckwdmfj	dTlfrkadEmfckwdmfj
wkddnjsdbxhd	wkddnjsdbxfhd
durtkcorwnd	durtkcWoerwnd
wlscnfgoehd	wlscnafgdoehd
tkwkddlanffuqkedkTek	WtkwkddlanffuqkedkTek
dksgrhekdid	dksTgrhekdid
dhsfkdlsdjqcp	dhsQfzkdlsdjqcp
vmfkdtmqodn	vmfrkdtmqodn
djejqkdlwjtm	djejqkedlwjtm
wlehahfms	wlehQahfms
tntnfyfmfauswpgksek	tntnfyfmftauswpgksek
rmadmsqhghk	trzmadmsqhghk
dlwndahrtna	dlwndrWahrtna
eotkddjqan	eotkddREjqan
soqnghlrPrhksfl	dsoqnghlrPrhksfl
wntlrtlwkddldhglfu	wntlrtlwkddlddhglfu
rhfueotodaud	rhfueotodauEd
wpdlfwjcnrdmsgod	wpdlfwjfcndrdmsgod
vkqtmdhzptmxmfj	vkqtRmdhzptmxmfj
rkadnjsrbah	rqkadnjsrbah
tlscnrdPwjd	tlscnrdzPwjd
tksgkrrhdehd	tksgkrrhdehsd
flsptktm	zflsptktm
wnakfwkdtp	wnsakftwkdtp
thdrmagkfuausdhlghkstlwkd	thqQdrmagkfuausdhlghkstlwkd
qustksqkseh	qusctksqkseh
tlsrbcncjs	tlsrbcncjvs
tkrmfjemfdj	tkrmfjemfdWj
thddosjffltmxm	thddosjffltmrxm
gkehfhrdbeh	gkehfhreEdbeh
tncjssusehddks	tncjssqusehddks
rndml3ehd	rndgml3ehd
dlrmqthrgl	dlrxmrqthrgl
antjsdlsxjsptdyrma	antjsdlsxwjvsptdyrma
soqnrjfoqlwnd	sgoqnrjfoqlwnd
diaktlxk	diaTktrlxk
emfdjtjfEoakek	emfdjtzjfEosakek
didtlatjsdjs	didtlatQjsdjs
durjsdmfwhtjdgk	durejsdmfwhtjdgk
todtkscpwp	todwtkscxpwp
ehddkakfkxhs	sehddkakfkRxhs
cpfpszksxm	cpfprszkWsxm
tlwkdqustn	tlwskdqustn
fhtmdoswpffptmqjqdnjs	fhtmdoswpffptmqjEqdnjs
ajrdlfmfwpeo	ajrdlqfmfwxpeo
wlflwjdqhtjqltmwprhd	wlflwjdqhtjqltmweprhd
rnemfoeorhd	rnemWfoeorhd
rnsalswjstks	rnsalsewjstks
rjatordjqcp	erjatordjqrcp
vudghktkdtntkd	vudghktkdtQntkd
wjdtlsrPtmd	wjdctlsrPtRmd
eogksandurxnwkwlsgmdrhdtk	eogksandurxnwkwlTsgmdrhdtk
dnlsehdnxp	dnlseehdnxp
dureochlrkd	dureoqechlrkd
wlwlrlqks	wlwalrlgqks
qnsdiddbgud	qnsdidRdbfgud
ekscpwhdahr	Eekscpwhdahr
dnsehdtjstn	ednsehdtjstn
gltmxhtmxpa	gltgmxhtmxpa
ehlsmsrjfl	ehlsmxsrjfl
gmlakddidqls	gmlcakddidqels
whgudcmraus	whTgudcmrWaus
rhddksrkatl	rhdcdksrkatl
tkadudxhdtls	tkadudxghdtls
dnsgkdguqdir	dnsgkdguqdadir
ehckrgowjd	ehcWkrgowxjd
tjdnfelwlxjf	tjdnfelrwlxjcf
rudrPfmfemfjso	rTuRdrPfmfemfjso
emrdmlqnsqo	temrvdmlqnsqo
rhkgkrthtjf	rhkgkrthtgzjf
roakrrhddus	roakarrhdduWs
cordladmfdlswjd	cordladTmfdlcswjd
ansghkrhksrhkdtltjfrhksfltkdjqth	ansghkrhksrhkdtltjfrhkwsfltkdjqth
dlqrnrdmfrjqn	dlxqrnrdmffrjqn
gksrnrrlchrhkgkrwldnjs	gksrnrrlchrhkgkrwldnfjs
snsrlfdmfwkqsms	snsrlfdmRfwkqsms
dlfrksdldyd	dRlfrksdldyd
aoaoehdgid	aowaoehdgixd
tlscjdtjfb	tlscjdftjfb
gksrnrtjqltm	gksrnfrtjqlEtm
dlsrlrktn	cdlssrlrktn
didwkrhksrP	didwkrhksrQP
ekaqodlstkarhd	ekadxqodlstkarhd
dldlrrhksfl	dldlrrhkTsfl
tlqrkstlqdlwl	tlqrkfstlqzdlwl
zyvkdlsostuf	zyvkdlqsostuf
dldjwlqkdrhdgkdwnd	dldjwlqfkdrhdgkdrwnd
dnjxjrpdlxm	dnjxsrjrpdlxm
tnghkrguswkd	tQnghkrtguswkd
wjdcorwjqahr	wjdcorwjQqahr
dpflrtmsqkrtk	dpflrtmsqEkdrtk
rhkdwnrudtjs	rhkdWwnrxudtjs
rkqkddmfRnal	rkEqkddmfRdnal
gkrrytjstod	gkrrytjdsxtod
Eofhsmsqhrwkqgk	Eofhsmsgqhrwkqgk
rkdskatkatjd	rkdsRkatkatsjd
ansghkrogur	answghkrotgur
dksehlqslekEh	dxksehlqslxekEh
duwkvpstld	duwkvpstrld
dlstkwkqdma	dlstkwQkqdma
tpfmfanffl	tzpfwmfanffl
chdrhkfwlgnlgodhs	chdgrhkfwlgnldgodhs
rhkgkrgkrtnfekscp	rhkgkrgkrtnfefksRcp
chlekvksao	chlekvgksao
tlgjatjqltm	tlgfjaatjqltm
tkckfeksqhrrnl	tkckfeksqhWrrnl
dmsgoddlskzkem	dmsgoddlswkzkem
duwktldrmf	duwkdtldrmf
qksehcpapdlzj	qksehcpapWdlzrj
tmzlxmdmlqkr	tmtzlxmdmlqkr
rnralstodghkfcpdbrguqdml	rnralstoTdghkfcpdbrdguqdml
ehdgotkacjr	ehQadgotkacjr
wjrqksgkwkd	wjrqvksgkwkdd
tndlqdlsel	tndlqdelseRl
rnswkdrnrrktksdjq	rdnswkdrnrrktksdjq
tjstnchsdmsrkftnfhr	tjdstnchsdmsrkftnfhWr
wltks2ehdwkd	wcltks2ehdwkd
rmsqhscnlwl	frmsqhscnlwl
qhdthogksmsrjtrhk	qhdthogksmrsrjtrhk
dlavlejstm	dlavlejstsxm
tjsrufanswp	tjsrcufanswp
gksrnrtkgkr	sgksrnrtkgkr
goekdwldurdpdlfwjd	tgoekdwRldurdpdlfwjd
snqkxlarhk	snqkxlarhfvk
ghkrqhgksenl	wghkxrqhgksenl
vlfdygksrufwjd	vlfdygksrufzwjd
dnlgowjsrltkdyd	dgnlgowjsrltkdyd
dydvnaghltk	dydvnaghlftk
shtkanswp	qshtkanswp
soahffkfk	soaThffakfk
ahshemfkak	ahshemfgkak
spxmdnjzmdjThtldpdlcm	spxmdnjzmdjThtldpdqlcm
dkstjdtlflq	dkstjdctxlflq
cjfsuxkdhfnsk	cjfsuxkdhfnwsk
vmflwmaqpscj	vmfqlwmafqpscj
soqnxhdwp	soqqnxhvdwp
vlgodigkseksmsrp	vlgEodigkseksmsrp
rbauddldlfnjwu	Rrbdauddldlfnjwu
cjdcnfdjfka	ecjdcnQfdjfka
wndtlawldpdnlclgk	wndtlaswlddpdnlclgk
tntorwkrdjq	tnteorwkrdjq
ghkfehdqjadnl	sghkffehdqjadnl
wjdrbdnjfem	Qwjgdrbdnjfem
tngorhdehd	tngRorhdehd
zjaekrxj119	zjaeskrxj11c9
ehddmlfmfdjedj	ehddmlfmfdgjedj
dkxpspdhfflavlr	dWkxpspdhfflavlr
rkrwhddmlghr	rkrwWhddmlfghr
wnfdlrhtkcodjq	wnfdalrhtkcodjq
wjsdpsoshkTdj	swjsdpsoshkTdj
audfkdtjsql	qaudfkdtwjsql
qhdtkwhdgkq	qhdtTkwhdgkq
Tlsmschkfdud	Tlsamschkfdud
vPdlstlrrl	vPdlsstRlrrl
wkdbfruddud	twkxdbfruddud
dptmdkdlxpzm	dptmdkdlxpszm
dlfqhsxkrrn	dclfgqhsxkrrn
rbsguddPtks	rbsqguddPWtks
skwdkwlftn	skwdkwlfdten
vhxhvmflsxj	vhxahxvmflsxj
thdtkschemdgkrry	thdtkschemdgdkrry
djfudnsrhtemfdl	djfzudnsrhtemsfdl
ansdPckdwkr	ansdPackdwkr
cnrkskrvhr	cnxrkskrvhr
didtkseogkrry	difdtksweogkrry
xldjemqkdl	xldjemgqkdl
qudtksthdwjscjfxkqtjfcl	qudttksthdwjscjfxkqtjfcl
tlemsldhfflavlrdlgn	tlemsldhfflawvlrdlgRn
dmlfltjdcjf	dmlfqltjdcqjf
vkffuqnsdid	vkffauqnWsdid
tkdjqsodyd	tkrdjqsodyd
ehfhrhdtkdptjdmsxhlgks	ehfhrhdqtkdptjdmsxhlgks
qnwjstlwkd	qnwjstlwdRkd
wlqnscjqnsgn	wlqnTscjqnsgn
akclsxladl	akclsqxladl
qkRdmfhqhsorh	qktRdmfhqhsorh
tkghldnsehddusrnthwkd	tkghldnsehdzdusrnthwkd
wjsansroqkf	wjsansroqkQf
tkdvnadmfqjfu	tkdRWvnadmfqjfu
tkemfdmlwpgbrk	tkemrfdmlwpgbcrk
rkdnsepgbaortm	rckgdnsepgbaortm
qhqltmfpsemfltm	qhqltzmfpsemflwtm
rhksdmaqhtkf	vrhksdmaqhtfkf
fhemflrptm	fhemftlrpRtm
gksmsdlaan	gkscmsdclaan
cndqnrandyd	cndqrnrandyd
akfndnsehdrudrl	akWfndnsehdrudrl
dhlrnrthssla	dhlrWnrthssla
glffldjemfkdl	Tglffldjemfkdl
xmrtnrydbrwlsgmdqjq	xmrtnrydqbtrwlsgmdqjq
skdhawlrgks	skdhawWlrgaks
wjsakddlgkgid	wjsakddlgkxgid
gksmszofha	grksmszofxha
wjsfurtksdjqrlqksrlrma	wjsfurtksdjqrlqksrtlrma
wkdirhvkf	wkdirhvtskf
qorwpansghkdmldjf	qorswpanscghkdmldjf
Rhcqkeclaxhd	Rhceqkeclaxhd
wndemdtksghk	wndemdtkwsgwhk
clfytkdls	clfytQkdgls
vlffkepfvldkqksehcp	vRlffkepfvlvdkqksehcp
flrmcnrrn	flrmcRnrrn
rnrwprmadbddusrntpsxk	vrnrwprmadbddusrntpsxk
gksekfdudkvenrh	gkcsekfxdudkvenrh
wpwnehghl	wpwnezhghl
emfdmsdbrhkdtjr	qemvfdmsdbrhkdtjr
wnddjwndans	wndgdjwndans
qnrkrlsmd	qnrkrlsmgd
wlqnfqhwmd	wlqnrfqThwmd
wlqkddmsgod	wlqkddzzmsgod
fkdlstlspak	fkdlstQlspak
ehorkskgodnstkdhk	gedhorkskgodnstkdhk
rhfemcc	rhfexmcc
altmxpfl	altmxgzpfl
wksduanfdlskawl	wksWduanfdlskawl
eogksalsrnrrhdrns	eogksqalsrgnrrhdrns
gksdncoRmx	gksrdncoRmx
ghksrudwkdnjs	ghksrtudwkdnjs
gksrnrqnstjrrlrl	grksrnrqnstjrrlrl
vpfmsksehqkrktm	rvpfmsksehqkrktm
quddurxmrfP	quddurxmQrfP
dnjssoeocorghldml	dnjssoeocorghTldml
whqudgmltkwkd	whqudgmltkwtkd
wlswjdgkschlrkdwkfh	wlswjedgkwschlrkdwkfh
ansghkfmfaksemfdj	anssghkfmfaksemfdj
ehdlqqldyd	ehxdlqqldyd
dnjsahrtkdxo	dnjsahrdtwkdxo
tkdghkssmdfur	tkdgRqhkssmdfur
xhdghkeksdnl	xhdghkseksdnl
dksdmfrlghlr	dksdmfrlgThlr
tlftkrlrksehddks	tlftkrlrksehddaks
wnxorrhdrks	wnxorrhdrkfs
dltkdcjstjs	dltkdcajstjs
glrktldlclzldur	glrktxldlclfzldur
ghskarhthr	qghskarhthr
ckadutlscjd	ckadutglscjd
gmltodwktn	Rgmltodwktn
fhajrducls	fhatjraducls
dmfshsdmlgk	dmfqshsdxmlgk
tmxkrhkdgkr	tmdxkrhkdgkr
ckdflqcnlwlans	ckdflqcnelwlans
rudwpxmrrngusdks	erudwpxmrrngusdks
gkfkrdmfdlfwjdqnqns	gkfkrdmfdlfwjdqenqnts
wjsrnrcnrrneoghl	Twjsrnrcfnrrneoghl
wjrcnldirtjd	Rwjrcnldirtgjd
sbdpsxlzlaghdrk	sbdpsxlzlagdhdrk
gkqqudrPghlr	gkqqudrPdzghlr
gkwlaksskctjs	gdgkwlaksskctjs
ghlrPtjfclalc	ghQlrrPtjfclalc
dlscnftkxo	dltscxnftkxo
cjdtksanffid	cejxdtksanffid
rpdlxmdnp	rpdlxmdnEWp
qnekdguadml	qndekdguadml
tkdfhrghxpf	tkdfhrgQhxpf
xpfktmxpzmshffjwl	xpfktmxpzmshffjwdl
rldjqdusrmawpeh	rldjqdusremawpeh
tprPfmfshffkrp	tpTrePfmfshffkrp
coaqjdhzptmxm	coeaqjdhzptmvxm
cjswjdzmfpdls	cjswjQdzzmfpdls
rltnfdlwjsryfbtpsxj	rltnfdlwjsryfbatpsfxj
qjqwjdrmsfh	qjqwjdtrmsfh
ehlsekauguseotkd	ehltsekauguseotkd
rkqnfrksmd	rzkqnTfrksmd
qkdldhqpscjrldjqwldnjstpsxj	wqkdldhqpscjrldjqwldnjstpsxj
rlfmadbcnf	ErElfmadbcnf
zhfldkgkdlxpr	Rzhfldkgkdlxpr
gksrkdtnrPwldur	egksrkdtnrPweldur
dudskadlfqh	xdudskadlfqgh
rhqnfchdfla	frhqnfchfdfla
cnfvksqneks	cnfvksqneeks
tlatktmdwls	WtlatktmQdwls
audtlagjrjTrnaksdy	audtlagrjrfjTrnaksdy
skdltmxmfptm	QskdlWtmxmfptm
zpdldptm	zpdldpttm
tnqorauddp	tgnqorauddp
rhfemakstkrtm	rhfemakstkcrtm
rmfhdnpfwjswk	rmfhdEnpfwjswk
cjfqurqneo	cjzQfqurqneo
smffutodtks	smfTfutsodtks
gksaldufflsrltnf	gkscalduRfflsrltnf
aharkqtEkdzhd	adharkqtEkdzhd
tlrlfmfshgcl	tlrlefmfshQgcl
skatjddmlfb	tskatjddRmlfb
dbwlsrhksrhkd	dbwlsrhkserhkd
wndwjwidtjd	gwndwxjwidtjd
qkfvydlgn	qkfQvydlgn
tjswjsdidh	tjswjsdidggh
xovudtleo	xQWovudtleo
dhlrhkrwhwlr	Edwhlrhkrwhwlr
rjstjfdmldk	vrsjstjfdmldk
dlsrksqhrwpghltk	dlsrksqhrwpgwhltvk
rygkqwkddosk	rygkqwkddWodsk
rudwpxhdrPwkfy	ruaddwpxhdrPwkfy
ekffjtjsanf	ekffjtjsanTf
ehddlfwjavh	eehddlfwjavh
ruddndlqjswn	rudsdndlqjswn
ekffjqnwhr	ekffjfqnwhr
qnstkstlzlsmfkwlsEka	qnsstkstlzlsmfkwlsREka
rnsdlsdutjd	rnsdlsfdutsjd
worPchdtn	wovrPchdtn
tlfwhddkehd	Etlfwhwddkehd
cpdbrtkdjq	cgtpdbrtkdjq
rlqkstltjfrhdtk	rlxqksetltjfrhdtk
zhemqnsgkfekwndwjqthr	zhemqnstgzkfekwndwjqthr
gksrnrwjdqhqhghtncnfwlsgmd	gksrnzrwjdqhqhghtncnfwlsgmd
dkzbxprqksehcp	dkzWdbxprqksehcp
rkadkapclrl	rkaTdkcapclrl
ghksaorhkwjd	eghksaorhkwjd
wjsdydrnwkd	wjsdydrnxdwkd
wpwntlcjd	wpwntlzcjd
tkanrlrl	tkaEnarlrl
vlxkfkdnsem	vlzxkfkdnsem
tlvdmsrjtdms	tlvdmsrjrtedms
vktksdlfks	dvktksdlfks
ansdidgorud	ansdidgoruaWd
dhtkddydrlwk	dhtkWfddydrlwk
dosltmxhs	dosltgmtxhs
tkdhldltk1dls	tqkdhldltk1dls
ehdansfhxjfl	ehdansfhxQjfl
ryxhdqhwh	ryxhrdqhwxh
dusrlgosoT	dWusrlgosoT
ekslsmszjavbxj	ekslcfsmszjavbxj
qpxpfkdqusghtk	qpxpfkdqusfghtk
rkrwhdwhghl	rkrRwhdwhghl
qkseoeocordnl	qkseofeoEcordnl
ehdntmdgk	ehdwntmdggk
tlrlwhwjdrnjsrh	tlQrlwhwjQdrnjsrh
tkdrkdnsdud	tkqdrkdnsdwud
akzmwpeh	avkzdmwpeh
dptjehrhksgodtkd	wsdptjehrhksgodtkd
rochldPwjd	rochEladPwjd
ehthaoel	ehfthaoel
aksemsrhdehd	aksemsrhdRehd
tjddnjsrjstjf	tjddnjsrjstjTf
tkdntmzofhffk	twkdRntmzofhffk
tjdnftkanth	tjdnftxkaEnth
qnrgkstjvhxjtm	qnrgEkstjvhxjtm
cnldjqqlwk	gcnldjqqlwk
tjqltmrlrhks	tjqtltmrlrhks
wlqnsthdb	wlqnsTethdb
ausekarhkwjd	auvsekarhkwjQd
dlgodksrk	gdlgodzksrk
qnrhkqkdcla	qnrhkqkfddcla
cnrkrudwjd	rcnrkrudwjd
fhRnfuwls	fhRngfuwls
rlarbstjqtjs	rTlarbstjWqtjs
wjdanswjdqh	wjsdasnswjdqh
cjrcnrmsdua	ecjrcnrmsdQua
dlsxjelwkdls	dQlsxejelwkdls
xpzmsltus	xpzrmsltus
alstnstlsTl	alstnstTlsTl
rmffhqjfwhwlr	rmeffhqjqfwhwlr
ghkdlxmgpem	ghkRdlxmgspem
qhffldduwk3dlswhd	qhffldduwk3dtlswhd
qntksapflshfquddnjs	qntksapflshfquvddnjs
fkdqkdxkdl	fkdqTkdxdkdl
wjdqhxhdtlstksdjqguqghl	wjdqhxhdtlstksdjqgucqghl
dydtlschemdgkrry	dydtlscshemdgkrry
rktmdjqwhd	rktxmdjqwhd
tpqjqrowjddpqksdud	tpeqgjqrowjddpqksdud
chrhkrmsan	chWrhkarmsan
zksnwhdahr	zksnwhdvQahr
Ekfmsshtkguq	EWkfmsshtkguq
tlatkeotkd	gTtlatkeotkd
rjenaughkdtjd	rjenaughkdtvjd
dldjakfus	dcldjRakfus
Qoshgdmftn	QoshgdmEftn
wodlfalseks	wodelfalseks
tkdlsdpdj	tkdlWswdpdj
aodlqgksdhlghk	saodlqgksdhlghk
dlepdhffmrl	dlepdhffrmrl
qlsrhsxkfcnf	qlEsrhsxkfcnf
rudwprydbrwkfy	rudwpxrydbrwkfey
vPwlrufwjd	RvPwlrufwjd
tlfwlrgksgn	tlfwlrgeksgn
tjdrhkwldur	ttjdrhRkwldur
dlcjscnftls	zdlzcjscnftls
qpscjzhfldkqpscj	qpscjzhfqldkqpTscj
todghkfcpdbrqnsdi	todghkfcpdbrqnQsdRi
thrgytjdrudrndyd	thrgqsytjdrudrndyd
qnrtjdusqkd	qnrtjdudTsqkd
cndwntprPantnfcnrwpcnwls	cndwntprPantnfcsnrwpcnwls
eogkswjsansrjstjf	eogkswjsanssrjstjf
dnjsdpskrckfqkedkT	dQnjsdpskrckfqgkedkT
rudwptjdwkdfbfdlwlsksgo	rudwptjdwkdfbfddlwlsksgo
tnwjdchemd	tnwjdcvhemWd
dudghkqormq	dudgxRhkqormq
tjdrhdeoghl	tjrdrhdeoWghl
cothtksdjq	ccovthtksdjq
dmfryaygl	dgmfryaygl
rjwlttlsghk	rjweflttlsghk
emdtkswhRl	emdwtkswqhRl
gkrheocnf	gwkvrheocnf
xlaehrmaapekf	xlaehrmqaapekf
rkaehrdlgk	rkaehRrdlgk
rladhkstjqTl	rlavdhwkstjqTl
rladlrwlsrl	rdladlrwlsrsl
zoavlddydvna	Ezoavlddydvna
