wjdrkdlsaor	wjddkdlsaor
wkqwlrhkdrh	wkqwlrhkdWh
whtpqneka	whRpTneka
dhglfudbgo	dhglfudbvo
qhfnspdh	Thdnspdh
wjtrkfrlacl	wjtrkfrlafl
tkatjdghkwo	tkatjaghkWo
wkehdckrhddjqguqehdwhgkq	wkehdckrhddjqguqehdThgkq
djqthemfdlsmf	djqthemfdlsmE
flghrhksrhkd	flthxhksrhkd
whdgkqqhrwlghlrhks	whdrkqqhrwlahlrhks
rnralsdlaeo	rnRalrdlaeo
qkrekfskan	qkrakfskan
dmaqksrPdir	dmaqksrPcir
qksdlghlckd	Tksdlghlckd
rkwkdrlrks	rkwkgrlrks
alswnxntk	alzwnxntk
gkqslekchlwhd	gkzvlekchlwhd
rlawngusrlwk	rlatngusrlsk
gkfkrqkdgid	gkfkrqkegid
dbtkdwmdwkgn	fbtkwwmdwkgn
xhdghksodur	chdfhksodur
ghksdbfwjdcor	Ehksdbfxjdcor
tkavhxpzm	Wkafhxpzm
ahxjtmakxm	fhxjtmakxm
tltmxparkaflguqghl	dltmxparkaflguqghl
Eoansdpgodhl	Eocnsdpeodhl
wltlreoruf	wltlceoruf
qlcjfrmathrwn	qlcjfrmsthrwn
xhdwmddmlgkr	xhdvmddmlgkr
rldjqqldyd	rldjqzldyd
ehtksdjqan	vhtksdjzan
durtlrjxahtmq	surtlrjxahcmq
fhalddlfks	fhaltdlfks
qkddjtneks	qkddjtnekg
vustjdrnrwkd	vustjdrnrwkQ
anffiddldb	znffiddldb
gjrktlscjd	gjrktlscjg
rhdtldkqls	rhdtldkRls
wjsrnrdjsfhs	wjErnrdjefhs
tjehwndrnr	tjWhwndrnr
cptlsdjqan	cptlsdjqvn
chqheksrP	chqhekswP
rlwlrjstjf	rlElrjstjf
qntlagodhkTdm	qntlagodhkgtm
dhlghkdPrma	dhlghkdPrmd
shtnpdlwls	shtnpdlwle
rkdgkanfwlf	Ekdgktnfwlf
gksrnrduwkvmfhrhfvmguqghl	gksrnrduwkwmfhrhfvmguqghl
fmfEjqkecl	fmaEjqkecl
dlstkqorud	slstkqowud
sofurksmsemd	sodurksmsemd
wkdsotprbs	wkesotprbs
rmqducprProvus	rmfducprProvus
akzptdlsdpdlqmffj	akzptdlsdpdlzmffj
qkseodufhs	qkseoxufhf
dmfhdlfrhks	dmfhdlxrhks
eotkdvnaahr	eockdvnaahr
qntksrnejrwn	qngkernejrwn
dmlghrqnqns	dmlehrqnqns
tntlqsusrks	tntlqwusrks
qnekddldlr	qnekdEldlr
tksdjqrltnf	tksdjqgltnf
rltnfgurtlstpsxj	rlvnfgurtlsTpsxj
eoehdquddnjs	Woehdquddnjs
wjdqhwnrnjs	sjdqhwndnjs
vhrxkswpwh	vhexkswpwh
vhrqkfwlrwjs	vhrekfwlrwjs
rytnemfdmlshf	rytnQmfdmlWhf
shsusrnjsdlrqhgh	Ehsuwrnjsdlrqhgh
toddjqdmfRnfurkf	tovdjqxmfRnfurkf
vjsemrmfnq	vjssmrmfnq
akdaudrlrks	akdaudqlrks
wkrmaskwwka	skrmaskwwkq
rmsangkejsghltk	wmsangkejsghltk
dlsxjsptqodzm	xlsxjspeqodzm
dlfqnqksqkf	glfqnqksqkf
rnstkqjqdnjs	rnstkzjzdnjs
xkwlrltmxks	xkwlrltmfks
wjsekdfltkdlxmfghf	wjsekdfltkWlRmfghf
qnvnarldjq	gnvnarlRjq
dlTsmstlso	dlTsmstlco
rlsmdeogkrwkd	rlsmreogkrakd
rhksrhkddnldnjs	rhksrhkdsnldnjs
wpgksgoddnl	tpgktgoddnl
rjatordlghkfrl	sjatorelghkfrl
vkfrhdskswkd	gkfdhdskswkd
xhdwkddlswk	shdwkddlswk
cowjasodur	cowjasoduv
gkqdml29qn	Rkqdml29qn
wjsdjwkqdl	wjwdjwkwdl
dlfmfqhrh	glRmfqhrh
skantwhrkr	zkantwhEkr
govlqjtm	govlqjam
tjswlsrmadbdrlqjqdmfhanwkdgk	tjswlsrmaTbdrlqjqdmfhanwktgk
dbfjqwnddkd	Wbfjqfnddkd
zofhffkdlskwn	zofhffkdlwkwn
fpwjwnxorrhdrks	fpwjTnxorrhdrks
ruddudgurtlsdpswls	rudduRgurtlsdpswls
rkrwhddkswjs	rkrwhdqkswjs
rydbrqhsqn	rydbrqhssn
rjtdmfhqhsms	rjtdmfhqhsmT
aorwngkswks	aoewngkswks
rydbrgbwlr	rydbTgbwlr
dldjrkftndlT	dlwjrkftndlT
tkatjdwjswkelwlxjf	rkatjdwjswkelWlxjf
tkcothrkr	tkdothrke
roffjfldptjduffls	roffjcldptjduffls
rlawptkfy	slawptkfy
dmfdmlalgk	dmfcmlalgk
wlansdlstlrtltmxpa	wlansWlstlrtltmxpa
qkddjwjsfir	qkzdjwjafir
ghkrwjdgoshg	ghkrqjdRoshg
guswltkdghkd	gucwltkdghkg
rudwodrhkwjd	RudwodrhkwjQ
skxkskTdmaudlsms	qkxkskTdmaudlsms
duwkxkrrn	duwkxkTWn
ekszkswltn	ekczkswltn
tkackdvmfkwkqlfeldqptmxm	tkackdvmfkQkqlfelcqptmxm
rhltksrnscjd	rhltkqrnscjd
rhdrmqworo	Thdrmqworo
ehzbajsxm	chfbajsxm
dptjwkwn	fptjwkwn
ansjwusofls	vnsjwusofle
dugodrPdir	duEodrPdir
emfdjtjsshgn	emfdjEjsshvn
cjsehrywnddkd	cjsehrywndfkd
eofbrghldeks	eofbdghldeks
dnfltkwnwhgkq	dndlEkwnwhgkq
qnrgkscpwp	gntgkscpwp
wmdtkswkrdjq	wmdtkswkrwjq
qustlsgksmsepgksahrt	qustlEgksmsepgksahrt
tkdjqwjsfirdm	Wkdjqwjsfirdm
Ektjdirtp	EktjrirTp
xhdghktltmxpa	xhtghktltmxpa
gkswkrjawjdsmdfur	gkswkrjawjdsmdfuT
dnthddPtnf	dnthdTPtnE
wlrwjqwhekf	wlrQjqwhekf
tmdflfmfrjenjTtmqsl	tmdflfmfrjenjTtmqWl
elwlxjfaleldjekswl	elwlxjfaleldjrkswl
dlstkarhdtk	dlsrkarhdtk
rhksflqnsdi	rhksWlqnsdi
wjdekdaudqn	rjdekdWudqn
ehrrkadPqkd	ehrxkadPqkd
duwkqorn	QuwkqoRn
rlaTlrkdl	flaTlrkdl
rhkrcndgheowjstjqn	rhkvcndgheowjstjfn
wpwkrgoqntksdktldks	wpwkrgoqntksektldks
dlTsmsrnaowkrma	elTsmscnaowkrma
vudrbssowo	vudrbTsowo
worhwktks	worhwkxks
guseovpdlsxm	euseovpdlsrm
ruddusaneo	ruddueaneo
rudrPtkdxo	rudvPfkdxo
vusdlthro	vusdlWhro
wlqnstmdhkvmanswp	wlqnstmdhkEmanswp
rhrmqwpvna	vhrmqwpvna
enlttlaqnwhr	enlttlaQnwhr
sbtmtkqjqwpwjd	sbfmtkqjEwpwjd
wjdrmawhwjsan	wjdEmawhwjscn
fkdntbvp	tkdntbvp
rkftnfhrrjtpwl	rkRtnfhrrjtpwl
dkfxkflan	dkfxkflrn
dkfmwpsxh	dkfmwpsah
wjsskashddjq	wjsskashddjz
qncofmftmdrP	qncofmfQmdrP
ansghkdudtkd	ansRhkdudtkd
xkgoddlcp	xkgodTlcp
eodhldltk	eodhldlfk
rhrordjqcp	ehroQdjqcp
ekfdhfmarmrwkd	ekfrhfmawmrwkd
fhcjscjsgl	fhRjscjsgl
dlfthsdlqnwhrgowls	dlvghsdlqnwhrgowls
wnxordmstjdnf	wnxorRmatjdnf
rmsrjfhtka	rmsrjfhwka
dnswjsausgj	dnswjgausgj
wmdwkfmfdnlgo	wmawkwmfdnlgo
dhqxhaowlr	dhqxhcoclr
dnlrlfmfakwrh	dnlrlfmcakwrh
alsthrakdmfcnwlswnsql	alsthrakdmfcnwlewnsql
wjsrnrduddjdndqus	wjsrnrdudtjdndqus
emfdprpdidqls	emwgprpdidqls
skadnjswldur	qkadnjswldur
dlTsmsfhdif	dlTsmsrhdif
rlaTlrkwnwkd	rlaelrkwnTkd
ckwdkrksmsrhkwjd	ckwdkrkamsrhkwjd
dPtksrbah	dPtkrWbah
durqoduftkdxorkrkf	durqoduftkdxorktkf
xnwkwjrrma	xnwkwjrrme
tmzkdnxm	amzkdnxm
rkdwhdrnrlwk	rkdRhdrnrlwk
eowjsguqwjd	eowjsguqwjW
tjdvnawjsekf	tjdvnxwjsWkf
ckddjqchrl	ckTEjqchrl
tkawjdwndn	tkawjdsndn
tlsehdrhddjq	tlsehwrhddjq
qhrrnqldyd	Ehrrnqldyd
gkdlxprdmswnrkdkswjd	gkdlfprdmswnrkdkswjd
dnjtldxjseogkr	dnjtldxjsdogkr
qhghwhcl	qhghfhcl
zhsptdnjfem	Rhsptdnjfem
rmarkdwpghk	rmaqkdwpqhk
dlaskdlfqhsqntjf	Wlaskdlxqhsqntjf
dbqordbTl	dbqoadbrl
tkdydgodh	tkQyRgodh
dbaudgodks	qbaudvodks
gudtkdjqxlawkd	guQtkdjqxlawkg
gmlfhdofkr	gmlfhdofkf
tpdlqtpcnfruftks	apdlqtpcnfruftks
dnfuroqhd	dnTuroqhd
ehdcndgkch	dhdcndgkch
wnddyalsthr	wnddyalEthQ
dPwjddlrks	xPwjddlrkc
tkdghkddmsdlemf	tkdghkdrmsdlemf
rmflsfkqpf	rmQlsfkqpf
dnwlswhdgkqrjstjf	dnwlswhdckqTjstjf
fmfdlxkfgkrj	fmfdlxkrgkrj
wjdtkdcnfrms	wjdtkQcnfrmx
wktlsrkadmfrkwrh	wktlsrkadmQrkrrh
cjdsusdlsrn	cjdsusdlsfn
thrduvksaogk	thqduvkqaogk
dhthdrnrwpqkdldhgkrtnfeoghl	dhwhdrnrwpqkdldhgkrtnfeoghl
ckfidwmdwjd	ckfidzmewjd
tjsrudandur	tjvrudandur
eoanstlwkd	doanstlwkd
xodjskwlswntkqja	xodjskwlswntkzja
wjdqnwhdgkq	wjdcnwhdgkq
ckdflqwkans	ckdzlqwkRns
rnrwpguqfurdmsgod	rnrwpgusfurdmsgoc
dnfldmsgodruddud	dnfldmsgocruddud
dhgn3tl20qns	dhwn3tl20Tns
tprP22dnl	vprP22gnl
eoaksdlfqhs	eoaksslfqhs
qhrhksxhfhrgo	qhahksxhfhrgo
wlsksgoqpdlwlddbslqjtldkemduwk	wlsksgoqpqlwlEdbslqjtldkemduwk
wkdrlxorqodnsthdrPdir	wkdrlxorfodnsthdrPdir
wjsqnrehghl	wjsqnxehghl
wnalsvusdlrtltjf	cnalsvusdlrtltjf
aleldjvmffpdldj9	aleldjvmTqpdldj9
tlsdydqlfeld	tlsdydqlaeld
tlsdlfqhstksdjq	tlrdlwqhstksdjq
xotjddlshxprdnjfem	xotjdflshxprdnjfem
qhrhksckdrhghkwo	qhrhksckdrhghkfo
rhdrhfmfghkrdlsgksenl	rhdrhfmEzhkrdlsgksenl
dksgrhdlTdmsk	dksgehdlTdmsk
ekdlsoalr	zkdlsoxlr
rlaehtnfTldlswl	rlaehtnfTldlsvl
qkfrnfrhkwjd	qkfrnfrhkrjd
rkwksmsrjt	rkwksmzrjt
threhqkdtn	threhqkxEn
dlswowjsfir	xlswofjsfir
rnjsdlrgidtkd	rnjQdlrgidtkd
tlsrhksehdeo	Elsrhksehdeo
dlTsmsrhsrud	rlTsmtrhsrud
tltmxpawpwh	tltmxpatpwh
qordjqthffntus	qordjRthffntuQ
andyddPtnf	zndyddPtnf
vkfkgrpqhdl	vkfkgspqhTl
gksmswndrnrcp	gksmWwnddnrcp
qnfrytktkd	qnfrytkEkd
qldydrnwh	qldydwnwh
wkdtpwjsghks	wkgtpgjsghks
wkdtnwldur	wkttnwldur
thfrhqkdldhapelzkf	thfqhqkdldhapelzkc
tlffurehrkwrh	tlWfurxhrkwrh
dmsgodehdrudwlwja	dmagodehdrudwlwjR
thskandhkqks	thskandhkakq
cnscjsqnfryqkdthd	cnTcjsqnfryqkdthd
xhdrPwkrdjq	ehdrPwkrajq
qnfqjqdjdjqgoddnl	qnfWjqdjdjqgoddnl
qotkdcordlaqhgja	Totkdcordlaqhgja
eoqnrcjqqh	eoqnrcjTqh
emddmfhghksruddhdua	zmddmfhghksruddhdua
ekffjtkdtmd	ekvfjtkdtmd
gkcjswjdghk	gkcjsEjdghk
wkawjdtkdyd	wkadjdtkdyr
tjsrjdlgn	tjsrjTlgn
rnwhdjqan	Rnwhdjqan
djrwlcnsgid	djzwlWnsgid
dlfdjsqksrn	dlfdjsqksan
thsusemfdmlaowkdwkdth	thsusemfdmlaowkzwkdth
gkqnrlrhks	gkqnWlQhks
gksrnrrnrdkrguqghl	gksrnrvnrdkrguqqhl
wjdrlrhdco	wjQrlrhdTo
smsguseotkdtjs	smscuseotkdtjs
wpqkdrhdtk	wpqkdRhwtk
aorudajsl	aoruaajsl
ekatndlwjs	ekatndlfjs
whdahremfrhkwn	whdahremRrhkwn
zkemeocnf	rkemeocnf
tnfuqghkfehd	tnfuqchkfehd
cnldjqwnsql	cnlTjqwnsql
endkshdhk	EndkshQhk
zkemruadyd	rkemruadyd
emfdmsekth	emfvmsekth
dusqkddmldnjs	dusqkddmldnjv
qkfptdmfchcjdgo	dkfptdmfchcjdgo
whdjqdjwkd	whdjxdjwkd
wmdtldirqkf	Rmdtldirqkf
tlalsgkrry	tltlsgkrry
wkehdwnans	qkehdwnans
dhvltmxpf4cmd401gh	dhvltmxpfgcmd401gh
rudwprhksrP	rudwprhksvP
tjehtjdwkd	tjahzjdwkd
wlwornjswjdtkdghldml	wlwornjswjdtkvghldml
alwmghvkdlsostufrmfnq	alwmghrkdlwostufrmfnq
rksghdjqan	rkgghdjqan
apdlfzmffjq	apRlazmffjq
rhkddurthrkr	rhkddurthxkr
shddirwpvna	RhddirwpQna
tkdptjchltjdghd	rkdptjchltjqghd
duftkrlsua	guftkdlsua
wldurquddnjs	wldurqudfnjs
dhkghwkdfyd	dhkEhwkdfyd
aorkrwldnjs	aorkawldnja
xhddlfdnsehd	xhddlfdnsthe
diekddmldnjs	diekdEmldnjd
cjflqkdqjq	cjflqkdtjq
aneksxnrl	aneksRnql
dptjsmswjdtkd	dprjsmWwjdtkd
rudrlrhksfka	rudrlrhkstkq
gksrufprmfla	qksWufprmfla
anfrkdusehd	gnfrkdusehg
ekaqodOrl	ekaqotOrl
wpwnehdutls	wpwnehTuels
vhrfurtjzmf	ghrfuWtjzmf
todrhrfldkv	todrhrdldkv
eoaksrhfvmtkdvna	eoaksrhvsmtkdvna
gksmlqkfka	gkfmlqkfkw
dlckwdkTdj	dlgkwdkvdj
tnwldkrghk	vnwldkrghk
rntjdehlscpwjd	rntjdehlTcpwjR
vlffmagudxo	vlffmacudxo
dhlrnrtjstn	dhlrnrvjftn
gksmsepehalvlfgks	xksmvepehalvlfgks
rkddnjswldur	rkddnjxwlzur
altnftprP	RltnftprP
rhdgkrtksdjqekswl	rhqgkrtksdjqekswl
vowjsxntn	vocjsgntn
todtksqkswkd	todtksqkszkd
zjstjfxjsem	zjstjfxjsvm
rltnfguqfur	rlRnfguqfur
dpsdptmrjscnrtjfrP	dpsdptmrjscnetjfrP
skdkrkrm	skRkrkrm
tmxlrmflcm	Emxlrmflcm
skatjdeksdnjs	skatjdeksdnja
voddlclrl	vodRlclrl
ryxhdrhksfusqjqrbdnlqks	rydhdrhksfusqjqrbdnlqks
eoxhdfudrhdqhtntjr	eoxhewudrhdqhtntjr
wkwjsrjahf	wkwjstjahf
dlsfurdmfcjftn	dlsfuRdmfcjfRn
wnrkstlsgh	wnvkftlsgh
toakdmfrmarhdkv	toakdmfrmaWhdkv
eostmeoghl	eovvmeoghl
tjdrhkrhksfus	tjdchkrhksfus
dlfqntmdth	Rlfqntmdth
dnpdjwjdvnatkdydahqja	dnpdjwjdvnatkgydzhqja
dpguqwhgksek	gpfuqwhgksek
qlTlfkdls	qlTlfkxls
shddjqrlqksrhdtk	shddjxrlqksrhdqk
dusrmrwpwhwlr	dusrmrwpvhtlr
wntlrdlsjan	wntlrdlEjan
tjddnjswnxorgkfqn	Ejddnjswnxorgkfrn
cprufrmador	cpruTrmWdor
duaksrkak	duakRrkak
tkagoeofla	tkagodoflT
qntksansghkghlrhks	qntksanErhkghlrhks
cjstkdnsehd	sjstkdnsehd
dksgsmsekrnrsotnvlfwjstjdcjf	dksgsmsekvnrsotnvlfwjstjdcjf
qhdlsmsdlehdxhdtls	qhdlsmsdlehdxhdRls
xmfpszmsms	xmfpsEmsms
qicptmffkvm	ciRptmffkvm
wldur18ro	wldur1fro
zhtmekrtlwkdemdfhr	zhtmWkrtlwkdemdEhr
eoghlwlrgn	Roghlwlrgn
wlqwndrkafl	wlqenvrkafl
rudrlrkRmxsks	rudrlrkTmxsks
dmsgodgkqqud	QmsgodgkEqud
Rmxekgsmsrmrht	vmxekgsmsrmrht
tkdjqdmfwns	wkdjqdmfwns
rmfjgrpehl	rmfjErpehl
rnrsodbcl	rntsodbWl
tngoakdmf	tngoakdmr
dmfvhgkago	dmfvhqkago
ghkswkrkatl	fhkswkrkatl
rhrmqqlffk	rhemqqlfdk
tmvhcmakzpxlddjq	tmvhtmakzpxlddjq
tkatksxorwl	zkgtksxorwl
eorntjqn	eoEntjrn
dlTeksmswjsakddlqsl	dlTfksmswjsakddlqsl
dlfqntlfldjf	dlfrntlfldjf
xldlstbdjfjstm	xldlstbQjfjstm
alrnrdusqkd	alrnrdusqkf
rudwpruddud	rudwpruRdud
qjqdnjsrudao	Qjqdnjsrudao
dmlskrvhrcnrth	dmlQkrvhccnrth
qhdksanswp	qhdksancwp
zpdldlTl	zpwldlTl
gpwlvjsemtkdjq	vpwlvjsemtkdjq
ektksqjqdlseoflwja	cktksqjqdlseoflWja
dusthrgkfkr	dusthrTkfkr
dhlqntkdghkd	dhlqntkaghkf
eogoddPchs	eogoddPchW
wlaudrudwod	elaudrudwod
cornjstltmxpa	cornjstlfmxpa
gudxodlamfhwoan	gudxodlamahwoan
skgPdbsTl	skgPdbsal
wldnjsduqn	wldnjsxuqn
dnjftmxmflwjsjf	dnjftmxmflwjfje
gkstoarnrdjwjsansrydbr	gkQtoarnwdjwjsansrydbr
eltmzjqjfltkdldjstmcosjf	Qltmzjqjfltktldjstmcosjf
emfdmlrkrquf	fmfdmlrkrquf
wkrlwntlrcnlemrtlsxkrrPdir	wkdlwntlrcnlemrtlsxkrrPdir
rpdlatmvkt	rpdlqtmvkt
djqanvmfhtptm	djqanwmfhtptm
cjsdjrdnjssmfdjskT	wjsdjcdnjssmfdjskT
rmarlfufdnjswn	rmarlWufdnjswn
qkdthdtjqltm	qkdthWtjqltm
dhlghksdmsgodemd	dhlghksvmsgodema
ghkswjrghkanf	ghkfwjrghkanf
wowjdthstlf	rowjcthstlf
wpwnvoszhfldkqhffld	wpwnEoszhwldkqhffld
cprkawltn	cprkewltn
skwdkwlrhqus	skwdkwlchqus
rkdwpwldtnqkddks	rkdwpcldtnqkddks
tjadbthworltnfroqkf	tjadbthTorltnfroqkf
dhkswjsxhdgkq	dhkswjvxhdgkq
tjryqlfeld	tjryqlzeld
tmfjdnsrk	dmfjdnsek
xnwkwjdcor	xnfkwjdEor
qotjejrkdska	totjejskdska
rhfemstbwm	rhfemvtbwm
gjdydgodkRkqrp	gjdydgodkRkqcp
rkwjdvhrfurcnqkd	wkwjdvhrfurcnqkd
gkrtnfghkfehd	qkrtnfQhkfehd
djflsayfmf	ejflsayfmf
akdlslcl	rkdlslcl
qnfvusEoans	qnfvurEoang
wjstprjfo	wjsWprjfo
rhkeoakdtkd	ahkeogkdtkd
wkcprltnf	wkcprltnr
rhqkftodgn	rhrkftodgn
xhdtlsthffntus	xhdclszhffntus
rndlqqneka	rndlWqneka
dudghkepqnl	dusahkepqnl
gkdntmrkarbf	gkdntmrkarba
wldurrltnfgurtls	wlduwrltnfgurtls
tjswjsghktk	tjswjswhkRk
skaausvkcnfthwkd	skaausvkcnfthwkq
tjsrjqkdwl	tjsrjqkawl
dltmqjrm	Qltmqjrm
zkemqnfqjq	zkemqnfqjx
duddjqdnlgja	duqdjqdnlgjE
wjdtlaghkghf	wjvtlaghkghf
shddjqrltnf	shddjqgltnf
clagogksmsrjt	clagogksmswjt
rhfvmvjxld	Qhfvmwjxld
skfksglruftmd	skfkfglruftmd
ehrehqkranfrhks	ehrehqkxanfrhks
ghkfehdeksdnl	ghkfvhdeksdnl
tjdnfdusxhd	tjdnfqusxhd
ryeochdwkd	syeozhdwkd
rjatkghkfehd	rjatkshkfehd
qnekagodirPdir	qnekaWodirPdir
qkrmekemdmf	qkrmekemxmf
dlemsEkfdl	dlQmWEkfdl
zmfpcmaj	xmfpcmaj
gkftnehdlTek	gkftnrhElTek
thaormadbdwlwja	Ehaormadbdwlwja
gksekrhtjrgkr	gksekrhgjrgkq
dkvdptjwlrwkd	Ekvdptjwlrwkd
tjddlstkdlxm	ejTdlstkdlxm
akdmfvPtn	akdmafPtn
eoqnfrnrrktksdjqekswl	eotnfrnrrktksdjqekswl
ckdlfhapekf	ckdlfhapxkf
sjanzjtj	sjrnzjdj
wjdqneowjscjdtk	wjdqneowjxcjdtk
tnfkrdustjf	tnfkEdurtjf
ghdcjsrnrehdbwlrhksfltkanth	ghdcjsrnrehdbwlrhkEflfkanth
Tkddydghkwo	Tkddywwhkwo
wpwngotn	gpwngotn
gksrnrwlflwjdqh	gksrnrwlflwjddh
xkdns434gh	ekdnt434gh
woqjf2tp	Qoqjf2tp
wjdqnrhksfy	wjdTnrhksfy
dlTdmaueksansaptlwltjqltm	dlTdmaueksansQptlwltjqlQm
rnehrrPdir	rnehTrPdir
tjdnfwldurqhsqn	tjfntwldurqhsqn
wlrtlgkfEo	wlztlQkfEo
rkaehrrlrhks	rkaehrrlRhks
vndanfansghk	vndanfensdhk
dkdlwmghfeldtmdl	dkdlwmghfelttmvl
wktkwjstl	wkzkwjztl
tldptjsmstnsckf	tldptjsmsxnsckf
djqrmfpdlem	djqxmfpdlem
didgustmdgksrnrrhkgkr	aidcustmdgksrnrrhkgkr
dlscjstkdfbr	dlscjstkRfbr
alrnrskaqn	alrneskaqn
wlsrudduwnd	wlsruRduwnd
gudtjdehlaustjdlxmfWo	gudtjdehlauQtjdlxmfWo
qkesmsrhkdwndmsgod	qkesmsrhkewndmsgod
wndeogkstk	wnteogkrtk
ehekfgksmssi	ehekfgkzmsqi
dlTsmsqPstudnwl	dlTsmsTPscudnwl
wncprnrals	wncprnrWls
wpqlwlqthtm	wpWlwlRthtm
wjfclsgkstk	ejfclsgkstk
tprPrlfhrdmfThe	tprPrlfhrdmaThe
wkrkvnawlf	wkrkvnarlv
tjfvjtmvmflddpahdls	tjfvjtmvmflddpRhqls
dbdmlwhdahr	dbdmlxhdahR
dkskarjstjfeovy	dkskarjctjfeoWy
dmfdnsdudgks	dmfdnrdudgks
qoraktkeks	qoraktkEkR
tlsrbemdfhrwhdahr	tlsrbemdfhrwhxaha
wkdusghksrud	wkcusghkszud
wlwlxhdtls	wlxlxhttls
gksqkdquddnjs	gksEkdguddnjs
ajswjqkdwltltjf	ajswjqkdwlxltjf
alsdmlthql	alsdmlthTl
dlstidldixm	clstidldixm
cjqqhdnltjd	cjqqhdnltjv
anfrkqusehdqns	anfrkqusQhdqns
rkdghekdnstlffur	akeghekdnstlffur
tkdghwkrdyd	tkrghwkEdyd
dlemfwnqus	dlemfwnfut
dhkchlrudfid	ghkchlrudfid
rPwhkdlcptjqltm	rPdhkdlcptjqltm
dhkfydtksdptjtlfwhd	dhkfyrtksdptjtlfwhd
xovudghkdnl	govudghkdnl
wowjdrudwpdnldnjs	Towjdrudcpdnldnjs
xmrfPdlqgkr	xmQfPdlqwkr
rkatlvudrkrPghlr	rkEtlvudtkrPghlr
rnrduddlfrks	rnvduddlfRks
cndcjdskaeh	endcjdskaeh
rhdwjdrjfo	rhdwjcrjRo
xntlswktkf	xntlfwkqkf
thwodjqcp	thcodjqEp
duddnjfwldur	dudTnjfvldur
zhfldkajcjs	zhfldkTjcjs
wldhzmfhs	wldhzmfhx
fkdpffldks	fkdpffldkv
rnrflqwjswkzjavbxj	rnrflqwjswkQjavbxj
fosemtkrks	Qosemtkrks
rhdgkddnsdud	rhdckddnsdud
rkdyvmfhrmfoa	rkdyRmfhrmfor
tkrurrudrl	tkRurrudrl
Tkfthqlrkath	TkfthWlrkath
todtksqnsdi	Qodtkdqnsdi
wjatnrudwod	Qjatnruxwod
vmfkselsk	vmxkselsk
wlsksgoakf	glsksgoakz
rhksrhkdruddud	rhkWrhkfruddud
cpqnfdlarma	cpqnfRlavma
dusrmatkdvna	duscmatkdvnR
rudwodrurghk	ruWwodruTghk
rhthrcjfehrhdeks	rhrhrcjfehrhteks
rhdtmqrPghlr	shdtmarPghlr
dbxhdwjsansdlsfur	dbxhdwjsansdlsfuQ
elwlxjfdudtkdwjwkd	elwlxjzwudtkdwjwkd
whtjseoqnthr	whgjWeoqnthr
todahflcm	todahQlcm
rnrxhdldydrPghlrqusrud	rnrxhdldydTPghlrqusrud
vywjddmsahen	TywjddmsRhen
rkqkdvldpfmrkfmepd	gkqkdvlxpfmrkfmepd
cjsdnjsWkfl	cjsdnjsvkfl
ekdidgkstkfPfmf	ekdidgkstkQPfmf
shgrhxhfhsgk	ghgrhwhfhsgk
ckrhksdmsrmfj	wkrhkfdmsrmfj
wlqgodrhkwjd	wlEgodrhkwjd
dkaghgoehr	dkachgoehz
wkdausdmsehdanf	vkdausdmsehdanf
qotkdtlscjd	Eotkdtlscjf
wpwnehdduwnd	wpwnehdQuwnd
aleldjrldjq	aleldjxldjt
cjdghkdgodyddhkdgmagid	cjdghkdRodyddhkdcmagid
dldjeoghl	dldjfoghl
dmlwndrjfltbt	dmlwndrjWltbt
gnqhwldur	gnWhwldur
gkseksmsdOrl	gksxksmsdOrl
tmvptuffltmxm	tmvptufvlrmxm
qoekdvmffjtm	qodkdvmRfjtm
wlausehdaus	wlauwehdfus
dbqnqkqdbqn	dbqnekqdbqn
wpwnwndansghxpf	wpwnwndansghtpf
dufjtdltj	dufjRdltj
gkfkrgksmsemd	gkfkrgkemsemv
doqmsbdml	doqmQbEml
gosemalrtj	gosemalstj
rhkdrhtndlreogoddjqwk	rhkdrhtndlxeogoddjqwk
xmrtnwjfehguadml	xmrenwjfehguadml
tkausgkfdls	tkausgkWdls
tmakxmzkemrhksfl	tmxkxmzkxmrhksfl
wldnjsdmfgown	wldnjsdmezown
qkrmekem	akrmekem
wktjrhals	wktjRhals
whrjsdmfaksg	whdjsdmfaksg
rkrndpdlfm	Qkrndpdlfm
rmfjsktlfwp	rmfjektlxwp
rhksflwjsakd	rhksflwjdakd
tpfptkdlxm	tpWpwkdlxm
tmtmfhdnjsclr	tmtmfhenjqclr
anrlwpgksguqwjd	anvlwpgksguqwjd
dlfrkadmfckwdmfj	dlfrkTdmvckwdmfj
wkddnjsdbxhd	wkddnjgdbrhd
durtkcorwnd	durtkcoqwnd
wlscnfgoehd	wlwcndgoehd
tkwkddlanffuqkedkTek	tkRkddlanffuqkefkTek
dksgrhekdid	dkssrhekdid
dhsfkdlsdjqcp	dhsfkdlsTjqqp
vmfkdtmqodn	vmfkddmqodn
djejqkdlwjtm	djvjqkdlwjtm
wlehahfms	wlshahfms
tntnfyfmfauswpgksek	tntnfyfmfauQwpRksek
rmadmsqhghk	rmadmsqhThk
dlwndahrtna	dlwnrahrtna
eotkddjqan	eotkTejqan
soqnghlrPrhksfl	sotnghlePrhksfl
wntlrtlwkddldhglfu	wntlrtlwkcdldhglfu
rhfueotodaud	rhfueotodauc
wpdlfwjcnrdmsgod	wpdldwjcnrdmsgoE
vkqtmdhzptmxmfj	vkqdmdhzptmdmfj
rkadnjsrbah	rkcdnjsrbah
tlscnrdPwjd	tlscnrfPwjR
tksgkrrhdehd	tksgktrhdghd
flsptktm	Tlspektm
wnakfwkdtp	wnzkfwkdRp
thdrmagkfuausdhlghkstlwkd	thdrmdgkfuausdhlghkstlwkd
qustksqkseh	dustksqkdeh
tlsrbcncjs	vlsrbcncjs
tkrmfjemfdj	Tktmfjemfdj
thddosjffltmxm	thddosjffltmQm
gkehfhrdbeh	gkehxhTdbeh
tncjssusehddks	vncjssusehdrks
rndml3ehd	rndmldzhd
dlrmqthrgl	glrmqThrgl
antjsdlsxjsptdyrma	antjsdlsxjspwdyrma
soqnrjfoqlwnd	sodnrjfoqlwnd
diaktlxk	eirktlxk
emfdjtjfEoakek	emfdjtjREoakek
didtlatjsdjs	didwlatjcdjs
durjsdmfwhtjdgk	durjsdmfwhtjdwk
todtkscpwp	todtkscpcp
ehddkakfkxhs	ehddkakfkahs
cpfpszksxm	cpfpsskzxm
tlwkdqustn	tlwkvquQtn
fhtmdoswpffptmqjqdnjs	rhtmdoswpffptmqjqdnjs
ajrdlfmfwpeo	ajrdlfmRwpeo
wlflwjdqhtjqltmwprhd	wlqlwjdqhtjqltmwprhd
rnemfoeorhd	rnTmfoeoqhd
rnsalswjstks	rnsalswjsdks
rjatordjqcp	rjaqordjqcp
vudghktkdtntkd	vudghkekdtntkd
wjdtlsrPtmd	wjdwlTrPtmd
eogksandurxnwkwlsgmdrhdtk	eogksandurxnwkqlsgmdrhdak
dnlsehdnxp	dnlrehRnxp
dureochlrkd	fureovhlrkd
wlwlrlqks	wlwlRlqks
qnsdiddbgud	qnsdidWbguR
ekscpwhdahr	ekscpchdghr
dnsehdtjstn	dnqehdtjstn
gltmxhtmxpa	xltmvhtmxpa
ehlsmsrjfl	ehlsmsrjgl
gmlakddidqls	gmlakdvidqle
whgudcmraus	whQudcmraus
rhddksrkatl	rhddkcrkatl
tkadudxhdtls	qkadudxhdxls
dnsgkdguqdir	gnsgkdguqdir
ehckrgowjd	ehckcgorjd
tjdnfelwlxjf	fjdnfelwlxjf
rudrPfmfemfjso	quzrPfmfemfjso
emrdmlqnsqo	emcdmlqnsgo
rhkgkrthtjf	rhkakrthtjf
roakrrhddus	roakrwhdduv
cordladmfdlswjd	cordladmadlswjd
ansghkrhksrhkdtltjfrhksfltkdjqth	ansghkrhksrhkdtltjfrhkwfltkgjqth
dlqrnrdmfrjqn	dlqrnrvmfrjqn
gksrnrrlchrhkgkrwldnjs	ckErnrrlchrhkgkrwldnjs
snsrlfdmfwkqsms	snsrlfdmfwkqqms
dlfrksdldyd	dlfrkqcldyd
aoaoehdgid	aoaoehfgid
tlscjdtjfb	tlscjafjfb
gksrnrtjqltm	gksxnrtjqlWm
dlsrlrktn	dlsrlzkrn
didwkrhksrP	WidwkrhksrP
ekaqodlstkarhd	ekatodlstkarhw
dldlrrhksfl	zldlrThksfl
tlqrkstlqdlwl	tlqQkstlqdlwl
zyvkdlsostuf	zyrkdlsoRtuf
dldjwlqkdrhdgkdwnd	dldjwlqkErhdgkdwnd
dnjxjrpdlxm	snjxjrpWlxm
tnghkrguswkd	snghkrguswkd
wjdcorwjqahr	wjdcorwjWahr
dpflrtmsqkrtk	RpWlrtmsqkrtk
rhkdwnrudtjs	rhkewnruRtjs
rkqkddmfRnal	rkqkddmERnal
gkrrytjstod	zkdrytjstod
Eofhsmsqhrwkqgk	wofhsmsqhrwkqgk
rkdskatkatjd	vkdskatkatjd
ansghkrogur	anxghktogur
dksehlqslekEh	dksehlqqlekEh
duwkvpstld	wuwkxpstld
dlstkwkqdma	dlstkQkvdma
tpfmfanffl	xpfmfangfl
chdrhkfwlgnlgodhs	chdrhkfwlgnleodhf
rhkgkrgkrtnfekscp	QhkWkrgkrtnfekscp
chlekvksao	chlckvkRao
tlgjatjqltm	flgjatjqlWm
tkckfeksqhrrnl	tkckfdksqhRrnl
dmsgoddlskzkem	dmsgoedlskzkem
duwktldrmf	duwktldrmv
qksehcpapdlzj	qksehWpcpdlzj
tmzlxmdmlqkr	tmzlTmdmlrkr
rnralstodghkfcpdbrguqdml	rnralstodxhkscpdbrguqdml
ehdgotkacjr	ehdgotkacjz
wjrqksgkwkd	wjrqksgkqkd
tndlqdlsel	snglqdlsel
rnswkdrnrrktksdjq	rnswkdrnrTktksdjq
tjstnchsdmsrkftnfhr	tjstnchsdmsrkvtnfhr
wltks2ehdwkd	wltkW2ehdzkd
rmsqhscnlwl	rmrqhscnlcl
qhdthogksmsrjtrhk	qhdQhogksmsrjtrhk
dlavlejstm	dlRvlejstm
tjsrufanswp	tjsrufangwp
gksrnrtkgkr	tksrnrtkgkr
goekdwldurdpdlfwjd	goekdwldurdpdlwwjd
snqkxlarhk	snTkxlarhk
ghkrqhgksenl	ghkrzhtksenl
vlfdygksrufwjd	vlfdygkszufwjd
dnlgowjsrltkdyd	dnlgoejtrltkdyd
dydvnaghltk	dydvnaThltk
shtkanswp	shQkanswp
soahffkfk	soahefkfk
ahshemfkak	ahshemxkWk
spxmdnjzmdjThtldpdlcm	TpxmdnjzmdjThtldpdlcm
dkstjdtlflq	Tkstjdtlflx
cjfsuxkdhfnsk	cjffuxkdhfnzk
vmflwmaqpscj	vmflvmWqpscj
soqnxhdwp	soznxhQwp
vlgodigkseksmsrp	vlgodigkEeksmsrp
rbauddldlfnjwu	Ebauddlxlfnjwu
cjdcnfdjfka	cjdcnfxjfka
wndtlawldpdnlclgk	wndtlswlvpdnlclgk
tntorwkrdjq	tntoewkrdjq
ghkfehdqjadnl	ahkfehdqjadnl
wjdrbdnjfem	wjdrbdnjfzm
tngorhdehd	tngorhdehc
zjaekrxj119	sjaekrxj11w
ehddmlfmfdjedj	ehdwmlfmfdjeej
dkxpspdhfflavlr	dkxpspThfglavlr
rkrwhddmlghr	rkrEhddmlghc
wnfdlrhtkcodjq	wntdlrhtkcodjq
wjsdpsoshkTdj	wjgdpsoshkTdj
audfkdtjsql	audfkdtjdql
qhdtkwhdgkq	qhdskwhdgkq
Tlsmschkfdud	Tlsmdchkwdud
vPdlstlrrl	vPdlstlcrl
wkdbfruddud	wkdbcruTdud
dptmdkdlxpzm	dptmdkclxpzm
dlfqhsxkrrn	dlfqhaxkvrn
rbsguddPtks	ebrguddPtks
skwdkwlftn	skwdkwlrtn
vhxhvmflsxj	vhthvmflrxj
thdtkschemdgkrry	thdtkschqmdgkcry
djfudnsrhtemfdl	djfudnsshtemfdl
ansdPckdwkr	ansdPwkdwkr
cnrkskrvhr	cnrkskQdhr
didtkseogkrry	didtkseogkEry
xldjemqkdl	xldjemwkTl
qudtksthdwjscjfxkqtjfcl	qudtksthdwjscjfxkQtjfcl
tlemsldhfflavlrdlgn	tlemsldhfflavltdlgn
dmlfltjdcjf	dmlfltjvcjf
vkffuqnsdid	vkftuqnsdid
tkdjqsodyd	xkdjqxodyd
ehfhrhdtkdptjdmsxhlgks	ehghrhdtkRptjdmsxhlgks
qnwjstlwkd	qncjstlwkQ
wlqnscjqnsgn	wlqnscjqnsWn
akclsxladl	akclszlaQl
qkRdmfhqhsorh	qkRdmfhqhEorh
tkghldnsehddusrnthwkd	tkghldnsehddusrnthxkd
wjsansroqkf	wjsWnsroqkf
tkdvnadmfqjfu	tkcvnadmfwjfu
tkemfdmlwpgbrk	tkemfdmlwpvbTk
rkdnsepgbaortm	gkdnsepgbaortm
qhqltmfpsemfltm	shqltmfpsemfltm
rhksdmaqhtkf	rhksdmaqhfkf
fhemflrptm	fhemflWptm
gksmsdlaan	gkqmsdlaan
cndqnrandyd	cnTqnwandyd
akfndnsehdrudrl	akWndnsehdrudgl
dhlrnrthssla	qhlrnrthsvla
glffldjemfkdl	glffldjrmxkdl
xmrtnrydbrwlsgmdqjq	xmrtnrydbvwlsgmdzjq
skdhawlrgks	skdhawlrtkr
wjsakddlgkgid	wjsakddlgkwid
gksmszofha	dksmszofha
wjsfurtksdjqrlqksrlrma	wjsfuQtksdjqrlqksrlfma
wkdirhvkf	wkrirhekf
qorwpansghkdmldjf	qortpansghkdmldjf
Rhcqkeclaxhd	Rhcqkeclaxhx
wndemdtksghk	wndemdrkwghk
clfytkdls	clfyskdls
vlffkepfvldkqksehcp	vlsfkepfvldkqksehcp
flrmcnrrn	vlrmcnrrn
rnrwprmadbddusrntpsxk	rnvwprmadbddusrntpsxk
gksekfdudkvenrh	gksekfdudkfenRh
wpwnehghl	wpwnehThl
emfdmsdbrhkdtjr	emedmsdbrhkdtjr
wnddjwndans	wnvcjwndans
qnrkrlsmd	qnQkrlsmd
wlqnfqhwmd	qlqnfdhwmd
wlqkddmsgod	wlqkddmsfod
fkdlstlspak	gkdlstlspak
ehorkskgodnstkdhk	dhorkskgodnsgkdhk
rhfemcc	rhfemQg
altmxpfl	altmQpal
wksduanfdlskawl	wksduanfdlwkawl
eogksalsrnrrhdrns	vogksalsEnrrhdrns
gksdncoRmx	gksfncoRmq
ghksrudwkdnjs	ghksWudwkdnjs
gksrnrqnstjrrlrl	ekswnrqnstjrrlrl
vpfmsksehqkrktm	vpfmsksehqkWktm
quddurxmrfP	qudduqxmrRP
dnjssoeocorghldml	dnjssoTocorshldml
whqudgmltkwkd	whqudgmlfkekd
wlswjdgkschlrkdwkfh	wlsxjTgkschlrkdwkfh
ansghkfmfaksemfdj	andghkfmfaksemfdj
ehdlqqldyd	ahWlqqldyd
dnjsahrtkdxo	dnjsdhrtkdso
tkdghkssmdfur	xkdghkssmdfus
xhdghkeksdnl	ehQghkeksdnl
dksdmfrlghlr	dksdmfElQhlr
tlftkrlrksehddks	tlztkrlrksehddks
wnxorrhdrks	wnxorrhErks
dltkdcjstjs	dlekdcjstjs
glrktldlclzldur	glrkRldlclzldur
ghskarhthr	ghgkarhthr
ckadutlscjd	ckaduRlscjf
gmltodwktn	gmltogwktn
fhajrducls	fhajrduclQ
dmfshsdmlgk	dmfshxEmlgk
tmxkrhkdgkr	tmxkdhkdgkr
ckdflqcnlwlans	ckdflxcnlwlans
rudwpxmrrngusdks	qudwpxmrrngusdks
gkfkrdmfdlfwjdqnqns	gkfkrdmfdlfwjdqnqng
wjsrnrcnrrneoghl	wjsrnrcnarneoghl
wjrcnldirtjd	wjrQnldidtjd
sbdpsxlzlaghdrk	sbdpsxlzlavhdrk
gkqqudrPghlr	gkqwuTrPghlr
gkwlaksskctjs	gkwlakQskctjs
ghlrPtjfclalc	ghlQPtjcclalc
dlscnftkxo	dlscnwtkxo
cjdtksanffid	cjdzksanffid
rpdlxmdnp	rpdltmdnp
qnekdguadml	fnekdguadml
tkdfhrghxpf	tkdQhrghxpf
xpfktmxpzmshffjwl	xpfktmxpzmshRfjwl
rldjqdusrmawpeh	rldjqdutrmrwpeh
tprPfmfshffkrp	tprPemfshffkrp
coaqjdhzptmxm	coaqjdhvptmWm
cjswjdzmfpdls	cjswjdzmfpsls
rltnfdlwjsryfbtpsxj	rlRnWdlwjsryfbtpsxj
qjqwjdrmsfh	qjqwjdamsrh
ehlsekauguseotkd	ehlvgkauguseotkd
rkqnfrksmd	rkqnfrksmT
qkdldhqpscjrldjqwldnjstpsxj	qkdldhqpscjrldjTwldnjstpsxj
rlfmadbcnf	rlfmavbcnf
zhfldkgkdlxpr	zhfldkgkdlxpt
gksrkdtnrPwldur	gksrkdtnWPwldur
dudskadlfqh	dudWkxdlfqh
rhqnfchdfla	rhqnfchdtla
cnfvksqneks	fnfvksqneks
tlatktmdwls	tlatktmdwlq
audtlagjrjTrnaksdy	audtlagjrjTrnakedy
skdltmxmfptm	wkdltmxmfptm
zpdldptm	zpgldptm
tnqorauddp	tnqoWaudfp
rhfemakstkrtm	rhfemakstkrvm
rmfhdnpfwjswk	rmfhdnpfgjswk
cjfqurqneo	cjWqurqneo
smffutodtks	smffutodtkQ
gksaldufflsrltnf	gkEaldufflsrltnf
aharkqtEkdzhd	aharkqtvktzhd
tlrlfmfshgcl	tlrlfmfshqcl
skatjddmlfb	skatjddmlgb
dbwlsrhksrhkd	dbglsxhksrhkd
wndwjwidtjd	wndwjvidtjd
qkfvydlgn	qkfvydlan
tjswjsdidh	tjswjrdidh
xovudtleo	xoWudtleo
dhlrhkrwhwlr	dhlrhkrwhglr
rjstjfdmldk	rjstjfdmlQk
dlsrksqhrwpghltk	xlQrksqhrwpghltk
rygkqwkddosk	rygkqwkxdosk
rudwpxhdrPwkfy	rudspxhdrPwkfy
ekffjtjsanf	ekffjtjsTnf
ehddlfwjavh	Thddlfwjavh
ruddndlqjswn	ruxdnElqjswn
ekffjqnwhr	wkvfjqnwhr
qnstkstlzlsmfkwlsEka	qnstkstlzlvmfkwlsEkv
rnsdlsdutjd	Tncdlsdutjd
worPchdtn	worPghdtn
tlfwhddkehd	tlfchddkehd
cpdbrtkdjq	spdbgtkdjq
rlqkstltjfrhdtk	rlqkstltjtrhstk
zhemqnsgkfekwndwjqthr	zhemqnsgkfekwncwjqthr
gksrnrwjdqhqhghtncnfwlsgmd	gksRnrwjdqhqhghtncnfwlagmd
dkzbxprqksehcp	Wkzbxprqksehcp
rkadkapclrl	Ekadkxpclrl
ghksaorhkwjd	ghksdofhkwjd
wjsdydrnwkd	sjsdydrnwkd
wpwntlcjd	wpwntlEjd
tkanrlrl	gkanrlfl
vlxkfkdnsem	vlxkfkdnTem
tlvdmsrjtdms	Tlvdmsrjtdms
vktksdlfks	vktkedlQks
ansdidgorud	ansqiWgorud
dhtkddydrlwk	dhtkdsydrlwk
dosltmxhs	woslvmxhs
tkdhldltk1dls	tkdhldlgkTdls
ehdansfhxjfl	ehgvnsfhxjfl
ryxhdqhwh	Eythdqhwh
dusrlgosoT	dusrlRosoT
ekslsmszjavbxj	gkslsmszjavbWj
qpxpfkdqusghtk	qpqpfkdqucghtk
rkrwhdwhghl	EkRwhdwhghl
qkseoeocordnl	qkseoeocosdnl
ehdntmdgk	ehdnemEgk
tlrlwhwjdrnjsrh	tlTlwhwjdrnjsvh
tkdrkdnsdud	tkdvkdnsdue
akzmwpeh	akzmtpxh
dptjehrhksgodtkd	dptjehrhkRgodtkd
rochldPwjd	rochldPfjd
ehthaoel	ehRhaoel
aksemsrhdehd	aksemsrhsehd
tjddnjsrjstjf	tjdrnjsrjszjf
tkdntmzofhffk	qkdntmzofhffk
tjdnftkanth	Rjdnftkanth
qnrgkstjvhxjtm	qnfgkstjvhxjtm
cnldjqqlwk	enldjqTlwk
tjqltmrlrhks	qjqltmglrhks
wlqnsthdb	Wlqnsdhdb
ausekarhkwjd	ausEkRrhkwjd
dlgodksrk	dlgodksfk
qnrhkqkdcla	qnrhkRkdqla
cnrkrudwjd	cnakrudwjW
fhRnfuwls	fhqnfuwls
rlarbstjqtjs	rlTrbstjqtjs
wjdanswjdqh	wjaanswjdeh
cjrcnrmsdua	cjrcnQmsdua
dlsxjelwkdls	dlRxjelwktls
xpzmsltus	xpzmwltus
alstnstlsTl	dlstnstlsTl
rmffhqjfwhwlr	cmffhqjfwhwlr
ghkdlxmgpem	ghkdlWmspem
qhffldduwk3dlswhd	qhefldduwk3dlswhd
qntksapflshfquddnjs	qntksapflshftuddnje
fkdqkdxkdl	fkzqkdRkdl
wjdqhxhdtlstksdjqguqghl	wjdzhxhdtlstksdjqguqrhl
dydtlschemdgkrry	dydvlRchemdgkrry
rktmdjqwhd	rktmdjWwhq
tpqjqrowjddpqksdud	tpqjqrowjzdpqksdud
chrhkrmsan	chrhkrmsen
zksnwhdahr	zksnThdahr
Ekfmsshtkguq	Ekfmsthtkguq
tlatkeotkd	tlstkeotkd
rjenaughkdtjd	gjenWughkdtjd
dldjakfus	dldjWkfus
Qoshgdmftn	xoshgdmftn
wodlfalseks	wodlfalteks
tkdlsdpdj	tkdlEdpdj
aodlqgksdhlghk	RodlRgksdhlghk
dlepdhffmrl	qlvpdhffmrl
qlsrhsxkfcnf	xlrrhsxkfcnf
rudwprydbrwkfy	rudwpzydbrwkEy
vPwlrufwjd	WPwlrufwjd
tlfwlrgksgn	tlfwlrgkWgn
tjdrhkwldur	tjqrhkwldur
dlcjscnftls	dlTjscnftls
qpscjzhfldkqpscj	qpscjzhfldkqpccj
todghkfcpdbrqnsdi	todghkfcpabrqnsdi
thrgytjdrudrndyd	thrgytjdTudrndyd
qnrtjdusqkd	qngtjausqkd
cndwntprPantnfcnrwpcnwls	cndvntprPantnfcnrwpcnwls
eogkswjsansrjstjf	eogkswjsansqjstjf
dnjsdpskrckfqkedkT	dnjsdpskrckaqkedkT
rudwptjdwkdfbfdlwlsksgo	rudwptjdwkffbfdlwlsksgo
tnwjdchemd	tnrjdchemd
dudghkqormq	sudghkqormq
tjdrhdeoghl	rjdrhdeoghl
cothtksdjq	coxhtksdjq
dmfryaygl	dmfryzygl
rjwlttlsghk	zjwlttlxghk
emdtkswhRl	emdzksghRl
gkrheocnf	gkrheoTnf
xlaehrmaapekf	xlaehwmaapekf
rkaehrdlgk	rkawhrRlgk
rladhkstjqTl	rladhkstjqsl
rladlrwlsrl	rlQdlrwlsel
zoavlddydvna	zoavlwdydvna
