wjdrkdlsaor	wjdrkdlsaPPor
wkqwlrhkdrh	wkqPwlirhkdrh
whtpqneka	whtpqnekla
dhglfudbgo	dhglfludbgo
qhfnspdh	nqhfinspdh
wjtrkfrlacl	wjtrkfrylacl
tkatjdghkwo	jtkatjdghkwo
wkehdckrhddjqguqehdwhgkq	wkehdcykrhddjqguyqehdwhgkq
djqthemfdlsmf	djqthbemfdlsmf
flghrhksrhkd	flghrphksrmhkd
whdgkqqhrwlghlrhks	whdgkqqhrwlghPlrhks
rnralsdlaeo	jrnralsdlaeo
qkrekfskan	qkrekOfskan
dmaqksrPdir	dmabyqksrPdir
qksdlghlckd	qksdylghlckd
rkwkdrlrks	rkwkdrPlrks
alswnxntk	alsjwnxnhtk
gkqslekchlwhd	gikqislekchlwhd
rlawngusrlwk	rlawngusrhlwk
gkfkrqkdgid	jgkfkrqkdgid
dbtkdwmdwkgn	dbtkdiwmdwkgn
xhdghksodur	xhdghkksnodur
ghksdbfwjdcor	ghmksdbfwjdcor
tkavhxpzm	btmkavhxpzm
ahxjtmakxm	hahxjtmaOkxm
tltmxparkaflguqghl	otltmxparkaflyguqghl
Eoansdpgodhl	Eoansdpgodhml
wltlreoruf	wltlyreyoruf
qlcjfrmathrwn	qlcujhfrmathrwn
xhdwmddmlgkr	xhdwmddmlgyhkr
rldjqqldyd	ryldjqqldyd
ehtksdjqan	ephtksmdjqan
durtlrjxahtmq	durtlrjxahtmPq
fhalddlfks	fhialddlpfks
qkddjtneks	qkdOkdjtneks
vustjdrnrwkd	mvustjdrnlrwkd
anffiddldb	anffiddljdb
gjrktlscjd	gjrktlsbcjd
rhdtldkqls	rhdtldkqlns
wjsrnrdjsfhs	wjsrnrodjmsfhs
tjehwndrnr	tPjehwndrnr
cptlsdjqan	cptlksdjqpan
chqheksrP	chqhekpsrP
rlwlrjstjf	brlwlrjstjf
qntlagodhkTdm	qntlagodhkTOdm
dhlghkdPrma	dhlghkdPnrma
shtnpdlwls	lshltnpdlwls
rkdgkanfwlf	rkdgkOanfwlf
gksrnrduwkvmfhrhfvmguqghl	gksrnrbduwkvmfhrhfvmguqghl
fmfEjqkecl	fmumfEjqkecl
dlstkqorud	dolstkqorud
sofurksmsemd	sofPurksmsemd
wkdsotprbs	wkdsotlprbs
rmqducprProvus	ruumqducprProvus
akzptdlsdpdlqmffj	akzptdlsdpdlqmuffj
qkseodufhs	qkseodufhOPs
dmfhdlfrhks	udimfhdlfrhks
eotkdvnaahr	ehotkdvnaahr
qntksrnejrwn	qntksirnejrwn
dmlghrqnqns	dmlghnrqnqns
tntlqsusrks	tntilqisusrks
qnekddldlr	qnelkkddldlr
tksdjqrltnf	tksdjqrltbnf
rltnfgurtlstpsxj	rlptnbfgurtlstpsxj
eoehdquddnjs	eoehdquddnmjs
wjdqhwnrnjs	wjPdqhhwnrnjs
vhrxkswpwh	Pvhrxkswpwh
vhrqkfwlrwjs	vhrqkfowlrwijs
rytnemfdmlshf	rytypnemfdmlshf
shsusrnjsdlrqhgh	shsusjrnjsdlrqhgh
toddjqdmfRnfurkf	mtoddjOqdmfRnfurkf
vjsemrmfnq	vjsemOrmfnq
akdaudrlrks	akPdauydrlrks
wkrmaskwwka	wkrmaskbwwka
rmsangkejsghltk	brmsangkejsghltk
dlsxjsptqodzm	dlsxjsyptqoOdzm
dlfqnqksqkf	dlkfqnqksqhkf
rnstkqjqdnjs	rjnstkqjqdnjs
xkwlrltmxks	xjkwlrltmxks
wjsekdfltkdlxmfghf	wjsekdfltkdlxplmfghf
qnvnarldjq	qnvnaruldjq
dlTsmstlso	dlTsmstllso
rlsmdeogkrwkd	rlismdeogkrwkd
rhksrhkddnldnjs	rhksrhkddinldnjs
wpgksgoddnl	wpogksgoddnl
rjatordlghkfrl	rjatordlghkbfrl
vkfrhdskswkd	vkfrhdPskswkd
xhdwkddlswk	xhdwkddlswjk
cowjasodur	Ocomwjasodur
gkqdml29qn	gkqdmol2h9qn
wjsdjwkqdl	wjsdjbywkqdl
dlfmfqhrh	dlfmfqphrhh
skantwhrkr	skantwhyrkr
govlqjtm	gPovlqjjtm
tjswlsrmadbdrlqjqdmfhanwkdgk	tjswlsrmadbdrlqjqdmfnhanwkdgk
dbfjqwnddkd	dbfjqwnddikd
zofhffkdlskwn	zofhfkfkbdlskwn
fpwjwnxorrhdrks	fpwjwnxorrhdrlks
ruddudgurtlsdpswls	ruddudghurtlsdpswnls
rkrwhddkswjs	nrkrwhddksywjs
rydbrqhsqn	rydbrqhsjbqn
rjtdmfhqhsms	rjtdmfhqhsmms
aorwngkswks	aorlwngkswks
rydbrgbwlr	ryydbrgbwlr
dldjrkftndlT	dldjrkftndlmT
tkatjdwjswkelwlxjf	tkatkjdwjswkehlwlxjf
tkcothrkr	tbkcothrkr
roffjfldptjduffls	roffjufldptjduffls
rlawptkfy	rlawpPtkfhy
dmfdmlalgk	dmfndmlalgk
wlansdlstlrtltmxpa	wlansdlstlrtltbmxpa
qkddjwjsfir	qkpddjwjsfir
ghkrwjdgoshg	ghkriwjdgmoshg
guswltkdghkd	guswltkdghmkd
rudwodrhkwjd	urudwodrhkwjd
skxkskTdmaudlsms	skxkskTPdmaudlPsms
duwkxkrrn	duwOkxkrrn
ekszkswltn	ekszkswklton
tkackdvmfkwkqlfeldqptmxm	tkackdvmfkwkqilfeldqptmxm
rhltksrnscjd	rhltmksrnscjd
rhdrmqworo	rhdrmnqworo
ehzbajsxm	ehzbajsxpm
dptjwkwn	jdptjwbkwn
ansjwusofls	ansujwusofls
dugodrPdir	dunngodrPdir
emfdjtjsshgn	emfdjtjsoshgn
cjsehrywnddkd	cjsehorywnddkd
eofbrghldeks	eofbOrghlbdeks
dnfltkwnwhgkq	dnfltkwnwhgkkq
qnrgkscpwp	qnrgkmscpwp
wmdtkswkrdjq	hwmdtkswkrdjq
qustlsgksmsepgksahrt	qustlOsgksmsepgksahrt
tkdjqwjsfirdm	tpkdjqwjsfirndm
Ektjdirtp	Ektjdiibrtp
xhdghktltmxpa	xnhdgyhktltmxpa
gkswkrjawjdsmdfur	gnkswkrjaowjdsmdfur
dnthddPtnf	dntohddhPtnf
wlrwjqwhekf	wlrwjqywhekf
tmdflfmfrjenjTtmqsl	tmdflfmmfrjenjTtmqsl
elwlxjfaleldjekswl	elwlxjfaleldjeksuwl
dlstkarhdtk	udilstkarhdtk
rhksflqnsdi	rhkspflqnsdyi
wjdekdaudqn	wjdekdaujdqn
ehrrkadPqkd	ehrrkadPqPkd
duwkqorn	duwkqoryn
rlaTlrkdl	rlaTnjlrkdl
rhkrcndgheowjstjqn	rhkricndgheowjstjqn
wpwkrgoqntksdktldks	wpwkrgoqntkjsdkPtldks
dlTsmsrnaowkrma	dlTsmnsrnaowkrma
vudrbssowo	ivundrbssowo
worhwktks	wiorhwktks
guseovpdlsxm	guspeovpdlsxm
ruddusaneo	rpuddjusaneo
rudrPtkdxo	rudriPtkdxo
vusdlthro	vuPsdlthro
wlqnstmdhkvmanswp	wlqnPstmdhkvmhanswp
rhrmqwpvna	yrhrmqjwpvna
enlttlaqnwhr	Penlttlaqnwhr
sbtmtkqjqwpwjd	sbotmtkqjqwopwjd
wjdrmawhwjsan	wyjdrmawhwjosan
fkdntbvp	fkdnmtbvp
rkftnfhrrjtpwl	rkyftnfhrrjtpbwl
dkfxkflan	dkkfxkflyan
dkfmwpsxh	dykyfmwpsxh
wjsskashddjq	wjsskoashddjq
qncofmftmdrP	qncofmfthmdrP
ansghkdudtkd	ansghkdmjudtkd
xkgoddlcp	xkgoddlOcp
eodhldltk	jbeodhldltk
rhrordjqcp	rhrorPdjqcp
ekfdhfmarmrwkd	ekfdhfmanrmrwkd
fhcjscjsgl	fhcjpkscjsgl
dlfthsdlqnwhrgowls	dlfthsodlqnwhrgowls
wnxordmstjdnf	nwnxordmhstjdnf
rmsrjfhtka	ormsrmjfhtka
dnswjsausgj	dnswjsauksgj
wmdwkfmfdnlgo	wmOdwkfmfPdnlgo
dhqxhaowlr	dhqhxhaowlr
dnlrlfmfakwrh	dnlrlfmfyhakwrh
alsthrakdmfcnwlswnsql	alshthrakjdmfcnwlswnsql
wjsrnrduddjdndqus	wjsrnrduddjdndquus
emfdprpdidqls	iemfdprpPdidqls
skadnjswldur	skadnjsjwldur
dlTsmsfhdif	dmlkTsmsfhdif
rlaTlrkwnwkd	rluaTlrkwnwkd
ckwdkrksmsrhkwjd	nckwdkrksmsrhykwjd
dPtksrbah	dPtksrbOah
durqoduftkdxorkrkf	durqoduftkdxorpkbrkf
xnwkwjrrma	xnwkwjrhrma
tmzkdnxm	tmznkdnxPm
rkdwhdrnrlwk	rkdwhdrnPrlwk
eowjsguqwjd	eowjbsgumqwjd
tjdvnawjsekf	tjdvnawpjsekf
ckddjqchrl	ckddjqbnchrl
tkawjdwndn	tkawjduwndn
tlsehdrhddjq	otlsmehdrhddjq
qhrrnqldyd	qhrrhnqldyd
gkdlxprdmswnrkdkswjd	gkdlxprdmswnrkdPkspwjd
dnjtldxjseogkr	ndynjtldxjseogkr
qhghwhcl	qmhghwhcl
zhsptdnjfem	zhspitdnOjfem
rmarkdwpghk	rmarkdwhpghk
dlaskdlfqhsqntjf	dloasjkdlfqhsqntjf
dbqordbTl	dbOqjordbTl
tkdydgodh	tkdydguojdh
dbaudgodks	dbuaudgodPks
gudtkdjqxlawkd	gudtkdjquxlakwkd
gmlfhdofkr	gmlfhdopfkr
tpdlqtpcnfruftks	tlpdlqtpcnfOruftks
dnfuroqhd	duhnfuroqhd
ehdcndgkch	ehdcnldgkch
wnddyalsthr	wndldyalsthr
dPwjddlrks	dPPwjddlPrks
tkdghkddmsdlemf	tkdlghkddmsdlemf
rmflsfkqpf	rmmfulsfkqpf
dnwlswhdgkqrjstjf	dnwlswhdgkqrjstPjf
fmfdlxkfgkrj	pfmfdlxkfgkrj
wjdtkdcnfrms	wjdtkdcnforms
wktlsrkadmfrkwrh	kwktlsrkadmfrkwrh
cjdsusdlsrn	cjdsnusdlsrn
thrduvksaogk	thrduvksnaogk
dhthdrnrwpqkdldhgkrtnfeoghl	dhthdrnrwpqkdldhgkrmtnfeoghl
ckfidwmdwjd	ckfidwmdpwjd
tjsrudandur	tjsrpudandur
eoanstlwkd	eoPanstllwkd
xodjskwlswntkqja	xodjskwlswntykqja
wjdqnwhdgkq	wjdqnwhdhgkq
ckdflqwkans	ckkdflqwkans
rnrwpguqfurdmsgod	runrwpguqfurdmsgod
dnfldmsgodruddud	dnflmdmsgodruddud
dhgn3tl20qns	dhgnP3tl20nqns
tprP22dnl	tprP22dnml
eoaksdlfqhs	eooaksdlfqhs
qhrhksxhfhrgo	qhrhksxhfhrbgo
wlsksgoqpdlwlddbslqjtldkemduwk	wlsksgoqpdlwlbddbsOlqjtldkemduwk
wkdrlxorqodnsthdrPdir	wkdrlxorqodnsthdrPodimr
wjsqnrehghl	wjsqnrehighl
wnalsvusdlrtltjf	wnallsvusdlrtltjf
aleldjvmffpdldj9	aleldjvmffpdldjj9
tlsdydqlfeld	tlpsdydqlfeld
tlsdlfqhstksdjq	tlsOdlfqhstksdjuq
xotjddlshxprdnjfem	xukotjddlshxprdnjfem
qhrhksckdrhghkwo	qhrhksckdrhughkwo
rhdrhfmfghkrdlsgksenl	rhdrhlfnmfghkrdlsgksenl
dksgrhdlTdmsk	dksgrhmdlTdmsk
ekdlsoalr	eykdlnsoalr
rlaehtnfTldlswl	rllaehtnfTldlswl
qkfrnfrhkwjd	qkfornfrhkwjd
rkwksmsrjt	rkwksmsmPrjt
threhqkdtn	threhqkodtn
dlswowjsfir	dlPswowjsfir
rnjsdlrgidtkd	rnjsdlrgidhjtkd
tlsrhksehdeo	tlsrhiksehdeo
dlTsmsrhsrud	PdlTsmsrhsrbud
tltmxpawpwh	tltimxpawpwh
qordjqthffntus	qordjqthffntuus
andyddPtnf	andypddOPtnf
vkfkgrpqhdl	vkfukgrlpqhdl
gksmswndrnrcp	gkbsmjswndrnrcp
qnfrytktkd	qnfrytukotkd
qldydrnwh	qbldydrnwh
wkdtpwjsghks	wkdtpwkjsghks
wkdtnwldur	wkdjhtnwldur
thfrhqkdldhapelzkf	thfrhOqkdldhapelzkf
tlffurehrkwrh	tllffurephrkwrh
dmsgodehdrudwlwja	idmsgodehdryudwlwja
thskandhkqks	tkhskandhjkqks
cnscjsqnfryqkdthd	cnscjsjqnfryqkdthd
xhdrPwkrdjq	xhdrPwPkrdojq
qnfqjqdjdjqgoddnl	qnfqjqdjdjmqgoddbnl
qotkdcordlaqhgja	qotkdcordblaqhgja
eoqnrcjqqh	eoqnirchjqqh
emddmfhghksruddhdua	emddOmfhghkmsruddhdua
ekffjtkdtmd	ekffjktkdtmd
gkcjswjdghk	gkcujswjdghk
wkawjdtkdyd	wkapwjdtokdyd
tjsrjdlgn	tnjsrjdlhgn
rnwhdjqan	rnwhhdhjqan
djrwlcnsgid	odjrwlconsgid
dlfdjsqksrn	dlfdjsqkmsrn
thsusemfdmlaowkdwkdth	thsusemfdmlaowkdwkdmth
gkqnrlrhks	gkqinrlrOhks
gksrnrrnrdkrguqghl	gksrnrrhnrdkrguqghl
wjdrlrhdco	wjbdrlrhdco
smsguseotkdtjs	sjmsguseotkdtjs
wpqkdrhdtk	wpqkdrhmdtk
aorudajsl	kaorkudajsl
ekatndlwjs	ekatndnlwjs
whdahremfrhkwn	whdpahremfrhkwn
zkemeocnf	zkemlneocnf
tnfuqghkfehd	tnfuqghkfyehd
cnldjqwnsql	cnldjqwnsqyl
endkshdhk	nendkshdhk
zkemruadyd	zkemruadyhd
emfdmsekth	emfdmosekth
dusqkddmldnjs	dusqkddjmldnjs
qkfptdmfchcjdgo	Oqukfptdmfchcjdgo
whdjqdjwkd	pwhdjyqdjwkd
wmdtldirqkf	bwmdtldirqkf
tlalsgkrry	tlmalsgkrry
wkehdwnans	wnkehdwnajns
dhvltmxpf4cmd401gh	dhvltmxpfj4cmd401gh
rudwprhksrP	rudwprhksPrP
tjehtjdwkd	tjehtjbdwkd
wlwornjswjdtkdghldml	wlywornjswjdtykdghldml
alwmghvkdlsostufrmfnq	alwmPghvbkdlsostufrmfnq
rksghdjqan	rksghdhjmqan
apdlfzmffjq	hapdlfzmfbfjq
rhkddurthrkr	rhkddurthhrpkr
shddirwpvna	shddirwpvuna
tkdptjchltjdghd	tkdptjchlntjdghd
duftkrlsua	duyftkrlsua
wldurquddnjs	wldurqpuddynjs
dhkghwkdfyd	dhkghwkdfyud
aorkrwldnjs	uaorkrwnldnjs
xhddlfdnsehd	xhddlfdnspehd
diekddmldnjs	diekddpmldhnjs
cjflqkdqjq	cjflqkOdqjlq
aneksxnrl	anebiksxnrl
dptjsmswjdtkd	odptjsmswjdtkd
rudrlrhksfka	urudrlrhkksfka
gksrufprmfla	gkbsorufprmfla
anfrkdusehd	yanfrokdusehd
ekaqodOrl	ekaiqodOrl
wpwnehdutls	wpkwnemhdutls
vhrfurtjzmf	vphrfurtjzimf
todrhrfldkv	todrhrfldkbv
eoaksrhfvmtkdvna	eoaksrhfvmtkodvna
gksmlqkfka	ygksmlqkfnka
dlckwdkTdj	dlckwdlkTdj
tnwldkrghk	thnwldkrghk
rntjdehlscpwjd	rntbjdehlscpwyjd
vlffmagudxo	vlffmaguydxo
dhlrnrtjstn	dhlrnrbtkjstn
gksmsepehalvlfgks	igkshmsepehalvlfgks
rkddnjswldur	rkddnjOslwldur
altnftprP	altynftpbrP
rhdgkrtksdjqekswl	ruhdgkrtksdjqekswl
vowjsxntn	voywjsxntn
todtksqkswkd	htodbtksqkswkd
zjstjfxjsem	zjsptjfxjsem
rltnfguqfur	rlthynfguqfur
dpsdptmrjscnrtjfrP	dpsdptmrjscnrtnjfrP
skdkrkrm	phskdkrkrm
tmxlrmflcm	tmxlrmflocm
skatjdeksdnjs	skatjdeksdnlOjs
voddlclrl	vododlclrl
ryxhdrhksfusqjqrbdnlqks	Oryxhdrhksfusqjqrbdlnlqks
eoxhdfudrhdqhtntjr	eoxhdfudrhdqohtntjr
wkwjsrjahf	wkwjsrjabhf
dlsfurdmfcjftn	pdlsfurdmfcjftn
wnrkstlsgh	wnrkmstlsgh
toakdmfrmarhdkv	btoakdmfrmarhdkv
eostmeoghl	elositmeoghl
tjdrhkrhksfus	tjdrhkrhksfnus
dlfqntmdth	dlfqnmtmdth
dnpdjwjdvnatkdydahqja	dnpdjwjdvnantkldydahqja
dpguqwhgksek	dpguqwhogksek
qlTlfkdls	qllTlfkPdls
shddjqrlqksrhdtk	shddjqbrlqksrhdtk
dusrmrwpwhwlr	djusPrmrwpwhwlr
wntlrdlsjan	wntlordlsjan
tjddnjswnxorgkfqn	tjoddnjswnxorgkfqn
cprufrmador	icprufrmador
duaksrkak	duaksrkank
tkagoeofla	tkagoOeofla
qntksansghkghlrhks	qntksansghkgihlrhks
cjstkdnsehd	cjstkdnynsehd
dksgsmsekrnrsotnvlfwjstjdcjf	dksgsmsekrnbmrsotnvlfwjstjdcjf
qhdlsmsdlehdxhdtls	qhdhlsmsodlehdxhdtls
xmfpszmsms	xmfpsznmsms
qicptmffkvm	qicptmffilkvm
wldur18ro	wlbdur18ro
zhtmekrtlwkdemdfhr	zhtmekrtlwkhdembdfhr
eoghlwlrgn	eoighlwllrgn
wlqwndrkafl	wlqowndrkafkl
rudrlrkRmxsks	rudrlrkpRmxsks
dmsgodgkqqud	ydmslgodgkqqud
Rmxekgsmsrmrht	uRnmxekgsmsrmrht
tkdjqdmfwns	tkbdyjqdmfwns
rmfjgrpehl	rmfjgrpehil
rnrsodbcl	rnrsodblcl
tngoakdmf	tnOgoPakdmf
dmfvhgkago	dmfvhigkpago
ghkswkrkatl	ghkswkrukautl
rhrmqqlffk	rhrmhqqlPffk
tmvhcmakzpxlddjq	tmvllhcmakzpxlddjq
tkatksxorwl	tkathksxorwl
eorntjqn	eonrintjqn
dlTeksmswjsakddlqsl	dlTeksmswmjsakddlqsl
dlfqntlfldjf	dlfqntlfoldjf
xldlstbdjfjstm	xldlstbdjOfjstm
alrnrdusqkd	alrnrdhiusqkd
rudwpruddud	riudwprudduod
qjqdnjsrudao	qjqdnjsrluudao
dmlskrvhrcnrth	dmjlskkrvhrcnrth
qhdksanswp	qyhdkskanswp
zpdldlTl	zpndnldlTl
gpwlvjsemtkdjq	glpwlvjsemtkdjq
ektksqjqdlseoflwja	ektksyqjqdlsmeoflwja
dusthrgkfkr	dusthrgjkfkr
dhlqntkdghkd	dmhlqntkdghhkd
eogoddPchs	oeogoddPchs
wlaudrudwod	wlauPdrudwod
cornjstltmxpa	cornjsltnltmxpa
gudxodlamfhwoan	gudxodlammfhwoan
skgPdbsTl	skkgPdbsTl
wldnjsduqn	wldnjsduiqn
dnjftmxmflwjsjf	dnjfptmxmflowjsjf
gkstoarnrdjwjsansrydbr	guhkstoarnrdjwjsansrydbr
eltmzjqjfltkdldjstmcosjf	beltmzjqjfltkdldjstmcosjf
emfdmlrkrquf	emfdmlrkrqhuf
wkrlwntlrcnlemrtlsxkrrPdir	wkrlwntlrcnlemrtlsxkrrPOdir
rpdlatmvkt	rppdylatmvkt
djqanvmfhtptm	djqanvmofhtptum
cjsdjrdnjssmfdjskT	cjsdjrdnjslsmfdjskT
rmarlfufdnjswn	rmarlfuufdnjswn
qkdthdtjqltm	qkdmthdtjqltm
dhlghksdmsgodemd	dhlghksdmsgodeymd
ghkswjrghkanf	ghkswjbrghkanf
wowjdthstlf	wowjdtihstljf
wpwnvoszhfldkqhffld	PwpOwnvoszhfldkqhffld
cprkawltn	cprkauwltn
skwdkwlrhqus	bskwdkmwlrhqus
rkdwpwldtnqkddks	rkdwphwldtnqkdbdks
tjadbthworltnfroqkf	tjadbthworltlnfrpoqkf
dhkswjsxhdgkq	dhknswjsxhdgkq
tjryqlfeld	tjuryqlfeld
tmfjdnsrk	tmfjdnsnrk
xnwkwjdcor	Pxnwkwjudcor
qotjejrkdska	pqmotjejrkdska
rhfemstbwm	rhfemstppbwm
gjdydgodkRkqrp	gjdydgondkRkqyrp
rkwjdvhrfurcnqkd	rkwjdvhrfurcbnbqkd
gkrtnfghkfehd	gkPrtlnfghkfehd
djflsayfmf	djflhlsayfmf
akdlslcl	akdlsllcl
qnfvusEoans	qnfvusEoanps
wjstprjfo	wjstprjmfo
rhkeoakdtkd	prhkeonakdtkd
wkcprltnf	wkcprltnpf
rhqkftodgn	rhqkftodpgn
xhdtlsthffntus	xhdtlPsthffpntus
rndlqqneka	rndlOqqnpeka
dudghkepqnl	dudghkenpbqnl
gkdntmrkarbf	Ogkdntmrkarbf
wldurrltnfgurtls	wldurrltnfguhrtls
tjswjsghktk	tbjswujsghktk
skaausvkcnfthwkd	skamausvkcnfthwkd
tjsrjqkdwl	utjhsrjqkdwl
dltmqjrm	dltomqjjrm
zkemqnfqjq	zkyemqnfqjq
duddjqdnlgja	duddljqidnlgja
wjdtlaghkghf	wjdotlaghkghf
shddjqrltnf	sihddjqrltnf
clagogksmsrjt	clagogksmbsrjmt
rhfvmvjxld	rhfyvmvjxld
skfksglruftmd	skfksgjllruftmd
ehrehqkranfrhks	ehrbehqkranfrhnks
ghkfehdeksdnl	ghkfehdenksdnl
tjdnfdusxhd	tjdbnofdusxhd
ryeochdwkd	ryeochdiwkd
rjatkghkfehd	rjatkPgOhkfehd
qnekagodirPdir	qnnekagodirPdir
qkrmekemdmf	qkmrmkekemdmf
dlemsEkfdl	dlkeomsEkfdl
zmfpcmaj	zpmfpcmaj
gkftnehdlTek	gokftneuhdlTek
thaormadbdwlwja	thaorymadbdwlwja
gksekrhtjrgkr	gksekrhtjirgkr
dkvdptjwlrwkd	dkvdptjwplrwPkd
tjddlstkdlxm	tjddlstkldlxm
akdmfvPtn	akdmfvPktn
eoqnfrnrrktksdjqekswl	eoqnfurnrrktkspdjqekswl
ckdlfhapekf	ckdljfhapekf
sjanzjtj	hsjanzjtbj
wjdqneowjscjdtk	wjdqneowjscjdhntk
tnfkrdustjf	tnfkurdustjf
ghdcjsrnrehdbwlrhksfltkanth	ghdcjsrnrehdbwblrhuksfltkanth
Tkddydghkwo	Tkddydmglhkwo
wpwngotn	wpOwngotn
gksrnrwlflwjdqh	gkhslrnrwlflwjdqh
xkdns434gh	xkkdns434gh
woqjf2tp	woqjof2tp
wjdqnrhksfy	wjdqnrhhksfiy
dlTdmaueksansaptlwltjqltm	dlTdmaueksansaptlwltjqbltm
rnehrrPdir	rnehrrPdilr
tjdnfwldurqhsqn	tjdnfwylPdurqhsqn
wlrtlgkfEo	wlortlgkfEo
rkaehrrlrhks	rkaehrrlrhkys
vndanfansghk	vnbdianfansghk
dkdlwmghfeldtmdl	dkdlwmgbhfeldtmdl
wktkwjstl	wkktkwijstl
tldptjsmstnsckf	tldptjsmsktnsckf
djqrmfpdlem	djqrmfppdlem
didgustmdgksrnrrhkgkr	bdidgustmdgksrnrrhkgkr
dlscjstkdfbr	dlscjstkdifbr
alrnrskaqn	aOlrnrskamqn
wlsrudduwnd	wjlsrudduwnd
gudtjdehlaustjdlxmfWo	gudtjdehlaustjdljxmfWo
qkesmsrhkdwndmsgod	qkemsmsrhkdwndmsgod
wndeogkstk	wndeohgksPtk
ehekfgksmssi	eOhekfgksmssi
dlTsmsqPstudnwl	dluTsmsqPstudnwl
wncprnrals	wncprnrPlals
wpqlwlqthtm	wpqlnwlqthtm
wjfclsgkstk	wjfyclsOgkstk
tprPrlfhrdmfThe	tprPrlfhrudmjfThe
wkrkvnawlf	wnkrkvnnawlf
tjfvjtmvmflddpahdls	tjfvjtmvmflddpamhdls
dbdmlwhdahr	dbdmlwhldahr
dkskarjstjfeovy	dkskarjstjfeokvy
dmfdnsdudgks	dmfpdbnsdudgks
qoraktkeks	qoraktkieks
tlsrbemdfhrwhdahr	bitlsrbemdfhrwhdahr
wkdusghksrud	wkdusghmksrpud
wlwlxhdtls	lwlwlxhdtls
gksqkdquddnjs	gksqukdqududnjs
ajswjqkdwltltjf	ajswjqokdwltltjf
alsdmlthql	alsdmlthihql
dlstidldixm	dlstidldixkm
cjqqhdnltjd	cjquOqhdnltjd
anfrkqusehdqns	anfrkquksehdqns
rkdghekdnstlffur	rkdghekdnstlfpfur
tkdghwkrdyd	tkdghwkrjdyd
dlemfwnqus	dllenmfwnqus
dhkchlrudfid	dhkchlroudfid
rPwhkdlcptjqltm	rPwhpkdlcptjqltm
dhkfydtksdptjtlfwhd	dhkfydtyksdptjtlfwhd
xovudghkdnl	xovudghlkdnl
wowjdrudwpdnldnjs	wowjdrudwpdnllldnjs
xmrfPdlqgkr	xmrfPdlqjgkr
rkatlvudrkrPghlr	rkatlvudrkrPgnhlr
rnrduddlfrks	rnrduddlfrkks
cndcjdskaeh	cndcjdhsjkaeh
rhdwjdrjfo	rhdwjdrjfbo
xntlswktkf	xntilswktkf
thwodjqcp	thwokdjqcip
duddnjfwldur	duddnjjfnwldur
zhfldkajcjs	zhflydkajcjs
wldhzmfhs	wldhizmofhs
fkdpffldks	fkdpfflmduks
rnrflqwjswkzjavbxj	rnrflqwjswkzjavnbxj
fosemtkrks	ufosnemtkrks
rhdgkddnsdud	rhdgkddnsdbiud
rkdyvmfhrmfoa	rkdykvmfhrmifoa
tkrurrudrl	tkrurrudrjl
Tkfthqlrkath	oTkfthkqlrkath
todtksqnsdi	toidtksqnsdi
wjatnrudwod	wjatynrudwod
vmfkselsk	vlmfkselsk
wlsksgoakf	hwlsksgoakf
rhksrhkdruddud	rohksorhkdruddud
cpqnfdlarma	cpqnfdllarma
dusrmatkdvna	dusrmatkpdvnka
rudwodrurghk	krudwodrurghk
rhthrcjfehrhdeks	rhtlhrcljfehrhdeks
rhdtmqrPghlr	rhdtOmqjrPghlr
dbxhdwjsansdlsfur	dbxhdbwjsansdlsfur
elwlxjfdudtkdwjwkd	elwlxhjfdudtkldwjwkd
whtjseoqnthr	whhtjseoqnthr
todahflcm	todmahflcm
rnrxhdldydrPghlrqusrud	ornrxhdldydrPghlrquPsrud
vywjddmsahen	vywjddmsOpahen
rkqkdvldpfmrkfmepd	rkqkdvldpfmrkfmephd
cjsdnjsWkfl	cpjsdnjsWkfl
ekdidgkstkfPfmf	ekjdidgkstkfPfmf
shgrhxhfhsgk	snmhgrhxhfhsgk
ckrhksdmsrmfj	ckrhksidmsrmfj
wlqgodrhkwjd	pwlqngodrhkwjd
dkaghgoehr	dlkaghgoekhr
wkdausdmsehdanf	wkdauysdmsehdaynf
qotkdtlscjd	qotkdPtllscjd
wpwnehdduwnd	wpuwnekhdduwnd
aleldjrldjq	aleldmjrldjq
cjdghkdgodyddhkdgmagid	cjdghbkdngodyddhkdgmagid
dldjeoghl	dldjeooghl
dmlwndrjfltbt	dmlbwndrjfltbt
gnqhwldur	gnqhPwldour
gkseksmsdOrl	gkseksmsdOryl
tmvptuffltmxm	tmviptuffltmxm
qoekdvmffjtm	Oqoekdvmffjotm
wlausehdaus	Pwlausjehdaus
dbqnqkqdbqn	dbjqnqkpqdbqn
wpwnwndansghxpf	wpwnlwndansghxpf
dufjtdltj	dufjltdlutj
gkfkrgksmsemd	gkOfkrgksmsemd
doqmsbdml	doqumisbdml
gosemalrtj	gosemaolrtj
rhkdrhtndlreogoddjqwk	rphkdrhtndlreogoddjqwk
xmrtnwjfehguadml	koxmrtnwjfehguadml
tkausgkfdls	tkausglykfdls
tmakxmzkemrhksfl	tmakxmzkkemrhksfl
wldnjsdmfgown	wldnjsdmfygoiwn
qkrmekem	hqkrmkekem
wktjrhals	wktjrhakls
whrjsdmfaksg	whrjsdmhfaksg
rkrndpdlfm	rPkrpndpdlfm
rmfjsktlfwp	rOmfjsktklfwp
rhksflwjsakd	rhksflhwjsakd
tpfptkdlxm	tpOfptkdylxm
tmtmfhdnjsclr	tmtmfhkdnjsclr
anrlwpgksguqwjd	anrmlwpgksguiqwjd
dlfrkadmfckwdmfj	dlforkadpmfckwdmfj
wkddnjsdbxhd	whnkddnjsdbxhd
durtkcorwnd	ndurktkcorwnd
wlscnfgoehd	jwlscnfgoehd
tkwkddlanffuqkedkTek	tkwkddlannffuOqkedkTek
dksgrhekdid	dksgrheokdid
dhsfkdlsdjqcp	dhsfkdulsdjqcup
vmfkdtmqodn	vmfkdtmqhodn
djejqkdlwjtm	djejqkdilwjtm
wlehahfms	wleuhahfms
tntnfyfmfauswpgksek	tntinfyfmfauswpgksek
rmadmsqhghk	urmadmsqhghk
dlwndahrtna	dulwndahrtna
eotkddjqan	eyotkdjdjqan
soqnghlrPrhksfl	soqngmhlrPrhksjfl
wntlrtlwkddldhglfu	wntlrbtlwkddldhglfu
rhfueotodaud	rhfueotodauod
wpdlfwjcnrdmsgod	wpdlfwjcnrdmsmgod
vkqtmdhzptmxmfj	vkqtmdhzptOmxmfj
rkadnjsrbah	rkadnjsrbaih
tlscnrdPwjd	tlscnrdiPPwjd
tksgkrrhdehd	tksmgkrPrhdehd
flsptktm	flsiptktim
wnakfwkdtp	wonakfwkdtp
thdrmagkfuausdhlghkstlwkd	thndrmagkfbuausdhlghkstlwkd
qustksqkseh	qoustksbqkseh
tlsrbcncjs	bOtlsrbcncjs
tkrmfjemfdj	tkrmfjemfbdOj
thddosjffltmxm	thddosjfifltmixm
gkehfhrdbeh	gkehfhjbrdbeh
tncjssusehddks	tncjssusehdidks
rndml3ehd	rhndmlO3ehd
dlrmqthrgl	dulrymqthrgl
antjsdlsxjsptdyrma	antjsOdjlsxjsptdyrma
soqnrjfoqlwnd	soqnrjfoqlwnPd
diaktlxk	diapkitlxk
emfdjtjfEoakek	iemfdjtjfEoakek
didtlatjsdjs	dyOidtlatjsdjs
durjsdmfwhtjdgk	durjsdmfwhtjhdgk
todtkscpwp	tlodtksucpwp
ehddkakfkxhs	ehddukakfkxhs
cpfpszksxm	cpfpszkPPsxm
tlwkdqustn	Ptlwkdqustn
fhtmdoswpffptmqjqdnjs	fhtumdoswpffpbtmqjqdnjs
ajrdlfmfwpeo	hajrdlfmfwpeo
wlflwjdqhtjqltmwprhd	wlflpwjdqhtjqlutmwprhd
rnemfoeorhd	rnemfoeorihd
rnsalswjstks	iornsalswjstks
rjatordjqcp	rjyatordjqcp
vudghktkdtntkd	vudghkthkdtntkd
wjdtlsrPtmd	wjdtlsrPtjmd
eogksandurxnwkwlsgmdrhdtk	eogksandurxnnwkwlsgmdrhdtk
dnlsehdnxp	dnlsehdnuxp
dureochlrkd	durebochlrkd
wlwlrlqks	wlpwulrlqks
qnsdiddbgud	qnsdiddbygud
ekscpwhdahr	ekosucpwhdahr
dnsehdtjstn	dnsehdtjstjn
gltmxhtmxpa	gltkmxhntmxpa
ehlsmsrjfl	elhlsmsrjfl
gmlakddidqls	gmlakddidbqlps
whgudcmraus	bwhgudcmraus
rhddksrkatl	rhjdodksrkatl
tkadudxhdtls	tkadudxjhdtls
dnsgkdguqdir	dnsgkOdguqdir
ehckrgowjd	ephckrgowjd
tjdnfelwlxjf	tjdnfulelwlxjf
rudrPfmfemfjso	rudrPfomfemfjso
emrdmlqnsqo	emrbdmlqnsqo
rhkgkrthtjf	rhkgkrtyohtjf
roakrrhddus	roankrrhddus
cordladmfdlswjd	cordladmfdlpOswjd
ansghkrhksrhkdtltjfrhksfltkdjqth	ansghkrhksrhkdtltjfrhksfltlkdjqth
dlqrnrdmfrjqn	dlqrnrdmfmrjuqn
gksrnrrlchrhkgkrwldnjs	gksrjnrrlchyrhkgkrwldnjs
snsrlfdmfwkqsms	snsrlfdmfwikqsms
dlfrksdldyd	bdlfprksdldyd
aoaoehdgid	aoaoehdigkid
tlscjdtjfb	tlscjndtPjfb
gksrnrtjqltm	gksOrnrtjqlltm
dlsrlrktn	dlsrnlrktn
didwkrhksrP	didwkrhlksrP
ekaqodlstkarhd	emkaqodlstkarhd
dldlrrhksfl	dldlrnrhksfl
tlqrkstlqdlwl	tlnqrkstlqdlwl
zyvkdlsostuf	zyvkdlnsuostuf
dldjwlqkdrhdgkdwnd	udldjwlqkdrhdgkdwnd
dnjxjrpdlxm	dnOjxjrpndlxm
tnghkrguswkd	tngyhkrguswkyd
wjdcorwjqahr	wjdcporwjqahr
dpflrtmsqkrtk	Pdpflrtmsqkrtk
rhkdwnrudtjs	rhkdwnroudtjs
rkqkddmfRnal	urkqkddmfRnal
gkrrytjstod	ugkrrytjstod
Eofhsmsqhrwkqgk	Eofhsmsqhmrwkqgk
rkdskatkatjd	rkdskatkahtjd
ansghkrogur	anhsghbkrogur
dksehlqslekEh	udksbehlqslekEh
duwkvpstld	duwkvpstlOd
dlstkwkqdma	dlstkwkPqdpma
tpfmfanffl	tpfnmfanfmfl
chdrhkfwlgnlgodhs	chdOrhkfwlgnblgodhs
rhkgkrgkrtnfekscp	rhokgkrigkrtnfekscp
chlekvksao	chOblekvksao
tlgjatjqltm	tlgjatjqyltm
tkckfeksqhrrnl	tkckfeksyqhrrnl
dmsgoddlskzkem	dmsPPgoddlskzkem
duwktldrmf	duiwktlldrmf
qksehcpapdlzj	bqksehmcpapdlzj
tmzlxmdmlqkr	tmzlxmOdmljqkr
rnralstodghkfcpdbrguqdml	rnralstodughkfcpdbrguqdml
ehdgotkacjr	ehdgotkacjor
wjrqksgkwkd	wjrqksgOkwkd
tndlqdlsel	tndlqdulseml
rnswkdrnrrktksdjq	rinswkdrnrprktksdjq
tjstnchsdmsrkftnfhr	tljstnchsdmsrkftnkfhr
wltks2ehdwkd	wltks2ehdiwkd
rmsqhscnlwl	rmsqphscnlwl
qhdthogksmsrjtrhk	qohdthokgksmsrjtrhk
dlavlejstm	ydloavlejstm
tjsrufanswp	Otjsrufanswp
gksrnrtkgkr	gksrnrtkgikr
goekdwldurdpdlfwjd	goekdwldurdpdlfowjd
snqkxlarhk	snqkxlarOhk
ghkrqhgksenl	gPhkrqhgkosenl
vlfdygksrufwjd	vlfdygksrufwnjjd
dnlgowjsrltkdyd	dnOlgowjsrlthkdyd
dydvnaghltk	dydPvnajghltk
shtkanswp	hshtkanswp
soahffkfk	sboahffkfk
ahshemfkak	ahshempfkak
spxmdnjzmdjThtldpdlcm	lspxmdnjzmdjThtmldpdlcm
dkstjdtlflq	dOkstjdtlflq
cjfsuxkdhfnsk	cOjfsuxkdhfnsk
vmflwmaqpscj	vmfljwmaqpschj
soqnxhdwp	ksoqnxhdwp
vlgodigkseksmsrp	vlgodigkseksimsrp
rbauddldlfnjwu	rbauddldlfnjwhu
cjdcnfdjfka	cjbdkcnfdjfka
wndtlawldpdnlclgk	wndtlawldpdnulclgk
tntorwkrdjq	tntoorwkrdnjq
ghkfehdqjadnl	ghkfemhdqjadnl
wjdrbdnjfem	wjOdrbdnjfem
tngorhdehd	tngorhldehd
zjaekrxj119	zjalekrxj119
ehddmlfmfdjedj	ehddmlfhmfdjedj
dkxpspdhfflavlr	dkxpspdhfflaivlr
rkrwhddmlghr	rkprnwhddmlghr
wnfdlrhtkcodjq	wnfudlrhtkcodjhq
wjsdpsoshkTdj	wjsdpsoshokTpdj
audfkdtjsql	audfkdtjsyiql
qhdtkwhdgkq	qhdtkiwhdgkq
Tlsmschkfdud	nTlsmschkfdud
vPdlstlrrl	vPbdlstlrrl
wkdbfruddud	kwkdbfruddud
dptmdkdlxpzm	dlpjtmdkdlxpzm
dlfqhsxkrrn	dllfqhsxkirrn
rbsguddPtks	rbsgudhdPtks
skwdkwlftn	skwdkwlpftnn
vhxhvmflsxj	vhxbhvmflsxj
thdtkschemdgkrry	thdtkschemndgkrry
djfudnsrhtemfdl	djfOudnsrhtemfdl
ansdPckdwkr	ansdPckdwikr
cnrkskrvhr	cnrkskrPvhr
didtkseogkrry	didtkPseogkrry
xldjemqkdl	xkldjemqkdl
qudtksthdwjscjfxkqtjfcl	qudtksthdwjjscjfxkqtjfbcl
tlemsldhfflavlrdlgn	Otlemsldhfflavlrdlgn
dmlfltjdcjf	dmlflltjdcjnf
vkffuqnsdid	vkffuqnsndid
tkdjqsodyd	tkdjqsodyOd
ehfhrhdtkdptjdmsxhlgks	ehfhrhdtkdptjdmsxhlgkks
qnwjstlwkd	qnwhjstlwkd
wlqnscjqnsgn	wlqnscjlqnsgn
akclsxladl	kakclsxladl
qkRdmfhqhsorh	qkRdmfhqhnsorh
tkghldnsehddusrnthwkd	tkghldnhsehddusrnthwkd
wjsansroqkf	wjsansrooqkf
tkdvnadmfqjfu	tkdvnadumfmqjfu
tkemfdmlwpgbrk	tkemfdmlwpgmbrk
rkdnsepgbaortm	rkdnmpsepgbaortm
qhqltmfpsemfltm	qhqltpmlfpsemfltm
rhksdmaqhtkf	rhksdmanmqhtkf
fhemflrptm	fhhoemflrptm
gksmsdlaan	gkslmsdjlaan
cndqnrandyd	cndqnranbdyd
akfndnsehdrudrl	akfndnsehdrudOrl
dhlrnrthssla	dhlrPPnrthssla
glffldjemfkdl	glfflpldjemfkdl
xmrtnrydbrwlsgmdqjq	xmhrtnrydbrwlsgmdqjq
skdhawlrgks	skldohawlrgks
wjsakddlgkgid	wjsakbddlgkgid
gksmszofha	gksmszofmha
wjsfurtksdjqrlqksrlrma	wjsfurtksdjqrlqksrlrmla
wkdirhvkf	wmkdirhvkf
qorwpansghkdmldjf	qorwopansghkhdmldjf
Rhcqkeclaxhd	Ryhcqkeclaxhd
wndemdtksghk	wndemdtkshghk
clfytkdls	clfytykdls
vlffkepfvldkqksehcp	vlffkepfvldkqksebhcp
flrmcnrrn	flrmcnprrn
rnrwprmadbddusrntpsxk	rnrwprmadbdkdusrnltpsxk
gksekfdudkvenrh	gksenkfdudkvenjrh
wpwnehghl	wpwnehghil
emfdmsdbrhkdtjr	emfdmsdbrhkdtkjr
wnddjwndans	wnpddjwndjans
qnrkrlsmd	qnnrkrlsmd
wlqnfqhwmd	wlqPnfqhwmd
wlqkddmsgod	wlqkdPdmsgod
fkdlstlspak	ofkdlstlspak
ehorkskgodnstkdhk	ehorkskgodnstkdohk
rhfemcc	rhfemcmkc
altmxpfl	ayltmxpfPl
wksduanfdlskawl	wksmduajnfdlskawl
eogksalsrnrrhdrns	eogksalsPrnirrhdrns
gksdncoRmx	gksdncouRmx
ghksrudwkdnjs	ghmkmsrudwkdnjs
gksrnrqnstjrrlrl	gksornrqnstjrrljrl
vpfmsksehqkrktm	vpfnmsksehqkrktm
quddurxmrfP	quddurpxmrfP
dnjssoeocorghldml	dnjssoeocorhghldml
whqudgmltkwkd	whquodgmltkwkd
wlswjdgkschlrkdwkfh	wlswjdgkyschlrkdwikfh
ansghkfmfaksemfdj	ansgmhkfmfakOsemfdj
ehdlqqldyd	ehydlqqldpyd
dnjsahrtkdxo	dnjshahrtkdxo
tkdghkssmdfur	otkdghkssmdfur
xhdghkeksdnl	xhdgOhkeksdnl
dksdmfrlghlr	dksdymfrlghlr
tlftkrlrksehddks	tlftkrlrksePhddks
wnxorrhdrks	wnxorrnhdyrks
dltkdcjstjs	dltkdcjstljs
glrktldlclzldur	glrktldlclzlidujr
ghskarhthr	bghskarhtohr
ckadutlscjd	ckaduthPlscjd
gmltodwktn	gmomltodwktn
fhajrducls	fhjajrdnucls
dmfshsdmlgk	idmfslhsdmlgk
tmxkrhkdgkr	tmxmkrhkdgkr
ckdflqcnlwlans	ckbdflqcnlwlanOs
rudwpxmrrngusdks	rudwpxmrrngusdkls
gkfkrdmfdlfwjdqnqns	gkfkrdmfdlfwjldqnqns
wjsrnrcnrrneoghl	wjsrmnrcnrrneomghl
wjrcnldirtjd	wjrcnldiPrtjd
sbdpsxlzlaghdrk	sbdpsxllzlaghdrk
gkqqudrPghlr	kgkqqudrnPghlr
gkwlaksskctjs	gkwluaksskctnjs
ghlrPtjfclalc	PghlrPtjfclalc
dlscnftkxo	dplscnftmkxo
cjdtksanffid	cjdtkksanffid
rpdlxmdnp	rpdloxmdnp
qnekdguadml	qnhbekdguadml
tkdfhrghxpf	tnkdfhrghxpf
xpfktmxpzmshffjwl	xpfktmxpzmsyhffkjwl
rldjqdusrmawpeh	rldojqdusrmawpeh
tprPfmfshffkrp	tprPfmmfsuhffkrp
coaqjdhzptmxm	coaqjdhzptmmxm
cjswjdzmfpdls	cjswjdzmfpdlis
rltnfdlwjsryfbtpsxj	rltnfdlwjsryufbtpsxj
qjqwjdrmsfh	Oqjqwjdrmsfh
ehlsekauguseotkd	enhlsekauguseotkd
rkqnfrksmd	rnkqnfrkbsmd
qkdldhqpscjrldjqwldnjstpsxj	qkyduldhqpscjrldjqwldnjstpsxj
rlfmadbcnf	rlufmadbcnf
zhfldkgkdlxpr	zhfldkghkdlxjpr
gksrkdtnrPwldur	gksrkdtnirPwldur
dudskadlfqh	duldskadlfqh
rhqnfchdfla	rhqnOfchdfla
cnfvksqneks	cnfyvkslqneks
tlatktmdwls	tlatktomdwls
audtlagjrjTrnaksdy	audtlagjrjTrnnaksdy
skdltmxmfptm	skdPltmxmfptm
zpdldptm	zpdlPdptm
tnqorauddp	tunqorauddp
rhfemakstkrtm	rhfemakstkrPitm
rmfhdnpfwjswk	rmfhdnpfwppjswk
cjfqurqneo	cjbfqurqmneo
smffutodtks	smOffuotodtks
gksaldufflsrltnf	gksalduufflsrltnf
aharkqtEkdzhd	ahaorkqntEkdzhd
tlrlfmfshgcl	ltlrilfmfshgcl
skatjddmlfb	skatlnjddmlfb
dbwlsrhksrhkd	dbwlsrhksnrhkd
wndwjwidtjd	whndwjwidtjd
qkfvydlgn	qkofvydlgn
tjswjsdidh	tjswjusdidh
xovudtleo	xovyudutleo
dhlrhkrwhwlr	dhhlrhkrwhwlr
rjstjfdmldk	rjstjfdmkldk
dlsrksqhrwpghltk	dlsrksyqhrwpghltk
rygkqwkddosk	Orygklqwkddosk
rudwpxhdrPwkfy	roudwpxhdrPwkfy
ekffjtjsanf	elkffjtjsanf
ehddlfwjavh	ehddlfwjavph
ruddndlqjswn	rbhuddndlqjswn
ekffjqnwhr	eykffjqknwhr
qnstkstlzlsmfkwlsEka	qnstkstlzlsmmfkwlsEkOa
rnsdlsdutjd	rnsndlsdutjd
worPchdtn	whorPchdtn
tlfwhddkehd	tlmfwhddkehd
cpdbrtkdjq	ncpdbrtkdmjq
rlqkstltjfrhdtk	rlqykstltjfrhdtk
zhemqnsgkfekwndwjqthr	zhemqnsgkfekwndwjqOthr
gksrnrwjdqhqhghtncnfwlsgmd	gksrnrwjdqhqohghtncnfwlsgkmd
dkzbxprqksehcp	dkzbxpjrqyksehcp
rkadkapclrl	rkajdkapclbrl
ghksaorhkwjd	ghksaorhkwOjd
wjsdydrnwkd	lwjsdydrnwkd
wpwntlcjd	wpwontlcjd
tkanrlrl	tkaPnyrlrl
vlxkfkdnsem	vlxkfkdnOsem
tlvdmsrjtdms	tllvdmsrjtdms
vktksdlfks	vkthksOdlfks
ansdidgorud	ansibdidgorud
dhtkddydrlwk	dhktkddlydrlwk
dosltmxhs	doshltmxhs
tkdhldltk1dls	tkdhldpltk1dls
ehdansfhxjfl	ehdansfhpxjlfl
ryxhdqhwh	rbyxhdqhwh
dusrlgosoT	duusrlgosoT
ekslsmszjavbxj	ekslsnmszjavbxj
qpxpfkdqusghtk	bqpxlpfkdqusghtk
rkrwhdwhghl	rmkrwhkdwhghl
qkseoeocordnl	qkseoeolcordnml
ehdntmdgk	ehhdntmhdgk
tlrlwhwjdrnjsrh	tlrlwhwjdkrnjsrh
tkdrkdnsdud	tkndrkdnsdiud
akzmwpeh	akozmwpkeh
dptjehrhksgodtkd	dptijehrhksgoudtkd
rochldPwjd	rlochldPwkjd
ehthaoel	ehpthaoiel
aksemsrhdehd	aksebmsrhdehd
tjddnjsrjstjf	tjnddnjsrjstjf
tkdntmzofhffk	tkdntmzmofhffk
tjdnftkanth	tjdnhftkanth
qnrgkstjvhxjtm	qnrgkstkjvhxjPtm
cnldjqqlwk	cnlydjqoqlwk
tjqltmrlrhks	tmjqltmrlrhks
wlqnsthdb	wjlqnsthdb
ausekarhkwjd	auisekarhkwmjd
dlgodksrk	dolgodksrk
qnrhkqkdcla	qnrmhkqkmdcla
cnrkrudwjd	lcnrkrudwjd
fhRnfuwls	fhRnnfuwls
rlarbstjqtjs	rhloarbstjqtjs
wjdanswjdqh	kwjdanswjdqh
cjrcnrmsdua	cjrlcnrmsudua
dlsxjelwkdls	dllsxjelwkdls
xpzmsltus	xpzmusltlus
alstnstlsTl	alstnsbtlsTl
rmffhqjfwhwlr	rmffhqjfwhwblr
ghkdlxmgpem	ghkdlxomghpem
qhffldduwk3dlswhd	qOhffldduwk3Odlswhd
qntksapflshfquddnjs	qntksapflshmfquddnjs
fkdqkdxkdl	lfkdqkdxkldl
wjdqhxhdtlstksdjqguqghl	wPjdqhxhdtilstksdjqguqghl
dydtlschemdgkrry	dydtlschemdgpkrry
rktmdjqwhd	rktmkdkjqwhd
tpqjqrowjddpqksdud	tpqjqrowjddpnqksdud
chrhkrmsan	chrhkrmsoaPn
zksnwhdahr	zkjsnwhudahr
Ekfmsshtkguq	Epkfmsshtkguq
tlatkeotkd	tlatPkeotkkd
rjenaughkdtjd	rjenkaughkdtjd
dldjakfus	dOldjOakfus
Qoshgdmftn	Qoshgdmfomtn
wodlfalseks	wodlfalsjeks
tkdlsdpdj	tkdOlsdjpdj
aodlqgksdhlghk	aodlqgksdhOlghk
dlepdhffmrl	dlepdhbffmrhl
qlsrhsxkfcnf	qlsrhsxkfPcknf
rudwprydbrwkfy	rudwprkykdbrwkfy
vPwlrufwjd	vPwlrufywjd
tlfwlrgksgn	tlfwilrgksgn
tjdrhkwldur	tjdurhkwldur
dlcjscnftls	dlulcjscnftls
qpscjzhfldkqpscj	bqpscjPzhfldkqpscj
todghkfcpdbrqnsdi	tlodglhkfcpdbrqnsdi
thrgytjdrudrndyd	thrgytjdrudnrndyd
qnrtjdusqkd	qnrtkjjdusqkd
cndwntprPantnfcnrwpcnwls	cndlwntprPantnfcnrwpcnwls
eogkswjsansrjstjf	eogkswjskansrjstjf
dnjsdpskrckfqkedkT	dnjsdpskrckfuqkedkT
rudwptjdwkdfbfdlwlsksgo	rudnwptjdwkdfbfdlwlsksPgo
tnwjdchemd	tnPwjbdchemd
dudghkqormq	dudghkjqiormq
tjdrhdeoghl	tjdrhbbdeoghl
cothtksdjq	coPthtksdjq
dmfryaygl	dmfryaygyl
rjwlttlsghk	rjwlttlsPghpk
emdtkswhRl	emldtkskwhRl
gkrheocnf	gkrheolcnf
xlaehrmaapekf	xlaehrimkaapekf
rkaehrdlgk	krkaeihrdlgk
rladhkstjqTl	rladhkstmjqTl
rladlrwlsrl	rlpadlrpwlsrl
zoavlddydvna	ozoavlddydvna
