wjdrkdlsaor	wbdrkdlsaor
wkqwlrhkdrh	wkqwlrhkdrO
whtpqneka	whtpqleia
dhglfudbgo	dpglfudOgo
qhfnspdh	qhfnsndh
wjtrkfrlacl	wbtrkfrbacl
tkatjdghkwo	tkatjdgyuwo
wkehdckrhddjqguqehdwhgkq	wpehdckrhddjqguqehdwhgkq
djqthemfdlsmf	djqthejfdlsmf
flghrhksrhkd	flgurhksrkkd
whdgkqqhrwlghlrhks	wpdgkqqhrwlghlrhks
rnralsdlaeo	rhralsdiaeo
qkrekfskan	qkremfspan
dmaqksrPdir	dmaqksrPdkr
qksdlghlckd	qksdlghlcmd
rkwkdrlrks	rkwkdrbrks
alswnxntk	alswjxotk
gkqslekchlwhd	guqslekchuwhd
rlawngusrlwk	rlawngusrlwm
gkfkrqkdgid	gkfirqldgid
dbtkdwmdwkgn	dmtydwmdwkgn
xhdghksodur	xhdghkskdur
ghksdbfwjdcor	ghksdbfwkdcor
tkavhxpzm	tpavhxnzm
ahxjtmakxm	ahxptmamxm
tltmxparkaflguqghl	tltmxparkaflghqghl
Eoansdpgodhl	EoaisdpgodPl
wltlreoruf	wltlreorif
qlcjfrmathrwn	qicjfrjathrwn
xhdwmddmlgkr	xhdwmddmOglr
rldjqqldyd	rldkqqldyd
ehtksdjqan	ehtlsdjqan
durtlrjxahtmq	durtirjxahtmq
fhalddlfks	fhalddlfPs
qkddjtneks	qpddjtneks
vustjdrnrwkd	vustOdrnrwkd
anffiddldb	anffiddldu
gjrktlscjd	gjrltlscjd
rhdtldkqls	rhdtldmqbs
wjsrnrdjsfhs	wjsrordnsfhs
tjehwndrnr	tjehwndrur
cptlsdjqan	cptPsdjqan
chqheksrP	chqOeksrP
rlwlrjstjf	rlwjrnstjf
qntlagodhkTdm	qntlagpdhkTdm
dhlghkdPrma	dhPghkdPrma
shtnpdlwls	shtPpdlwls
rkdgkanfwlf	rbdgkalfwlf
gksrnrduwkvmfhrhfvmguqghl	gksrnrduwkvmfhrhfvmguqgmo
fmfEjqkecl	fyfEjqkecm
dlstkqorud	dlstkqorpd
sofurksmsemd	sofirksmsemd
wkdsotprbs	wydsotprbs
rmqducprProvus	rmqdicprProvus
akzptdlsdpdlqmffj	akzotdlsdpdlqmffj
qkseodufhs	qbseodufhs
dmfhdlfrhks	dmfhdlfrmks
eotkdvnaahr	eotkdvmaajr
qntksrnejrwn	qntPsrnejrwn
dmlghrqnqns	dmlghrqjqns
tntlqsusrks	tntlqsusrbs
qnekddldlr	qPekddldlr
tksdjqrltnf	tksdpqrltnf
rltnfgurtlstpsxj	rltnfgPrtlstpsxj
eoehdquddnjs	eoeidquddnjs
wjdqhwnrnjs	wjdqiwnrnhs
vhrxkswpwh	vhrxlswiwh
vhrqkfwlrwjs	vhrqkfwirwjs
rytnemfdmlshf	rytnemfdilsnf
shsusrnjsdlrqhgh	shsusrnjsdlrqygh
toddjqdmfRnfurkf	toddjqdmfRpfurOf
vjsemrmfnq	vmsemrbfnq
akdaudrlrks	akdaudrlrps
wkrmaskwwka	wkrmasOwwla
rmsangkejsghltk	rnsangmejsghltk
dlsxjsptqodzm	dlsxnsptqodzm
dlfqnqksqkf	dlfqbqksqbf
rnstkqjqdnjs	rnstlqjqdyjs
xkwlrltmxks	xkwlrltmxPs
wjsekdfltkdlxmfghf	wjsekdfitkdlxmfgmf
qnvnarldjq	qnviarldjq
dlTsmstlso	dlTsjstlsk
rlsmdeogkrwkd	rbsOdeogkrwkd
rhksrhkddnldnjs	rhksrukddlldnjs
wpgksgoddnl	wpgksgPddnl
rjatordlghkfrl	rhatordlghkfrh
vkfrhdskswkd	vkfrhdshswud
xhdwkddlswk	xhdwlddmswk
cowjasodur	cowoasbdur
gkqdml29qn	gkqdmb29qn
wjsdjwkqdl	wpsdjwjqdl
dlfmfqhrh	dlfmfqhro
skantwhrkr	skajtwhrkr
govlqjtm	govlqmtm
tjswlsrmadbdrlqjqdmfhanwkdgk	tjswlsriadbdrlqjqdmfhanwkdgk
dbfjqwnddkd	djfjqwnddkd
zofhffkdlskwn	zoflffidlskwn
fpwjwnxorrhdrks	fpwmwnxorrhdrks
ruddudgurtlsdpswls	ruddudgurtlsdpswjs
rkrwhddkswjs	rkrwhddkswOs
rydbrqhsqn	rOdbrqhsqh
rjtdmfhqhsms	rjtdmfhqPsms
aorwngkswks	aorwkgkswks
rydbrgbwlr	rydbrgbwpr
dldjrkftndlT	dldjrkftndpT
tkatjdwjswkelwlxjf	tkatkdwjswkelwlxjf
tkcothrkr	tkcothrur
roffjfldptjduffls	roffjfldptjduffPs
rlawptkfy	rlawmtkfy
dmfdmlalgk	djfdmlalgb
wlansdlstlrtltmxpa	wlansdlstlrthtPxpa
qkddjwjsfir	qkddjwjsfpr
ghkrwjdgoshg	ghkrwmdgosbg
guswltkdghkd	guswltpdghkd
rudwodrhkwjd	rudwodrukwjd
skxkskTdmaudlsms	skxkskTdmaudksms
duwkxkrrn	duwkxkrru
ekszkswltn	ebszhswltn
tkackdvmfkwkqlfeldqptmxm	tkackdvmfkwpqlfeldqptmxm
rhltksrnscjd	rhitksrnscjd
rhdrmqworo	rhdrnqworo
ehzbajsxm	ehzbajsxP
dptjwkwn	dptjwuwm
ansjwusofls	ansjwjsofls
dugodrPdir	dugodrPdkr
emfdjtjsshgn	emfdjtjsshgb
cjsehrywnddkd	cjsehrywuddkd
eofbrghldeks	eofbrgPldeks
dnfltkwnwhgkq	dnfutmwnwhgkq
qnrgkscpwp	qnrgkscpwP
wmdtkswkrdjq	wmdtkswnrdjq
qustlsgksmsepgksahrt	qustlsghsmsepglsahrt
tkdjqwjsfirdm	tkdOqwjsfbrdm
Ektjdirtp	Ebtjdirtp
xhdghktltmxpa	xhdghktltmxOa
gkswkrjawjdsmdfur	gkswkrjawjdsydfur
dnthddPtnf	dothddPtnf
wlrwjqwhekf	wbrwjqwoekf
tmdflfmfrjenjTtmqsl	tmdflfmfrjeijTtmqsl
elwlxjfaleldjekswl	elwlxjfaheldjekswl
dlstkarhdtk	distkarhdtk
rhksflqnsdi	rhksflqysdi
wjdekdaudqn	wjdekdaydqn
ehrrkadPqkd	ehrrkadPqPd
duwkqorn	duwbqorO
rlaTlrkdl	rlaTorkdl
rhkrcndgheowjstjqn	rhkrcbdgheowjstjqn
wpwkrgoqntksdktldks	wpwkrgoqntlsdktldks
dlTsmsrnaowkrma	dlTsnsrnaowkrma
vudrbssowo	vudrlssowo
worhwktks	worhwkths
guseovpdlsxm	gkseovpdlsxm
ruddusaneo	ruddhsaueo
rudrPtkdxo	rudrPtidxo
vusdlthro	vOsdlthro
wlqnstmdhkvmanswp	wuqnstmdhkvmakswp
rhrmqwpvna	rhrbqwpvna
enlttlaqnwhr	enmttiaqnwhr
sbtmtkqjqwpwjd	sbtmtkqjqwpwpd
wjdrmawhwjsan	wjdrmawhwjsao
fkdntbvp	fodjtbvp
rkftnfhrrjtpwl	rnftnfirrjtpwl
dkfxkflan	dhfxkflan
dkfmwpsxh	djfbwpsxh
wjsskashddjq	whsskashddjq
qncofmftmdrP	qmcofmftPdrP
ansghkdudtkd	ansghkdodtkd
xkgoddlcp	xygoddlcp
eodhldltk	emdhldlto
rhrordjqcp	rhrurdPqcp
ekfdhfmarmrwkd	eofdhfmarmrwkd
fhcjscjsgl	fbcjscjsgO
dlfthsdlqnwhrgowls	dlfthsdlqnwhrgowis
wnxordmstjdnf	wnxbrdmstjdlf
rmsrjfhtka	rmsrjfmtka
dnswjsausgj	dyswPsausgj
wmdwkfmfdnlgo	wmdwkfmfdplgo
dhqxhaowlr	dhqxOaowlr
dnlrlfmfakwrh	dnlrlfmfakwrk
alsthrakdmfcnwlswnsql	alsthrakdmfcnwlswnsqn
wjsrnrduddjdndqus	wksrnrduddhdndqus
emfdprpdidqls	emfdorpdidqls
skadnjswldur	soadnjswydur
dlTsmsfhdif	dlTsmsfidif
rlaTlrkwnwkd	rlaTlrOwnwid
ckwdkrksmsrhkwjd	ckwdkrksusrhkwjd
dPtksrbah	dPtksrOaP
durqoduftkdxorkrkf	durqodnftkdxorkrjf
xnwkwjrrma	xnwbwjrrma
tmzkdnxm	tmzhdnxi
rkdwhdrnrlwk	rPdwkdrnrlwk
eowjsguqwjd	eowjsguqwhd
tjdvnawjsekf	tjdvlawhsekf
ckddjqchrl	ckddPqchrl
tkawjdwndn	tkawjdwndO
tlsehdrhddjq	tlseldrhddjq
qhrrnqldyd	qhrroqpdyd
gkdlxprdmswnrkdkswjd	gkdlxprdmswnrodkswjd
dnjtldxjseogkr	dnjtldxjseogbr
qhghwhcl	qhghwhcp
zhsptdnjfem	zhsptdljfem
rmarkdwpghk	rlarkdwpghk
dlaskdlfqhsqntjf	dlasodlfqhsqntOf
dbqordbTl	dbqordyTl
tkdydgodh	tOdndgodh
dbaudgodks	dbaudgodis
gudtkdjqxlawkd	gudthdjqxlawkd
gmlfhdofkr	ghlfhdoflr
tpdlqtpcnfruftks	tudlqtpcnfruftis
dnfuroqhd	dnfuruqbd
ehdcndgkch	eudcndgkch
wnddyalsthr	wnddnausthr
dPwjddlrks	dPwjddlrOs
tkdghkddmsdlemf	tkdgykddmsdlemf
rmflsfkqpf	rbflsfhqpf
dnwlswhdgkqrjstjf	dnwuswhdgkqrjstbf
fmfdlxkfgkrj	fmfdlxkfghrj
wjdtkdcnfrms	wjdtydcmfrms
wktlsrkadmfrkwrh	wktksrkadmfrkwrh
cjdsusdlsrn	cjdsnsdlsrn
thrduvksaogk	tOrduvksaogk
dhthdrnrwpqkdldhgkrtnfeoghl	dhthdrnrwpqkdldhgkrtnfeogkl
ckfidwmdwjd	ckfOdwPdwjd
tjsrudandur	tjsrudaodpr
eoanstlwkd	eoanstnwkd
xodjskwlswntkqja	xodjskwlswOtyqja
wjdqnwhdgkq	wkdqnwhdgkq
ckdflqwkans	ckdfyqwians
rnrwpguqfurdmsgod	rnrwyguqfurdhsgod
dnfldmsgodruddud	dnfmdmsgodrhddud
dhgn3tl20qns	dhgn3tk20qns
tprP22dnl	torP22dnl
eoaksdlfqhs	eoaksdjfqhs
qhrhksxhfhrgo	qhrhksxhfhrgP
wlsksgoqpdlwlddbslqjtldkemduwk	wlsksgoqpdlwlddbsnqjtldkeoduwk
wkdrlxorqodnsthdrPdir	wkdrlxbrqodOsthdrPdir
wjsqnrehghl	wusqnrehghn
wnalsvusdlrtltjf	wnalsvusdPrtOtjf
aleldjvmffpdldj9	aleOdjvoffpdldj9
tlsdydqlfeld	tlsdydqlfeod
tlsdlfqhstksdjq	tlsdlfqhstpsdjq
xotjddlshxprdnjfem	xotjddlshxprdymfem
qhrhksckdrhghkwo	qhrjkscbdrhghkwo
rhdrhfmfghkrdlsgksenl	rhdrhfmfghkrdysgksenl
dksgrhdlTdmsk	dksgrhduTdmsk
ekdlsoalr	ekdlsjalr
rlaehtnfTldlswl	rlaehtPfTldlswl
qkfrnfrhkwjd	qkfrnfrkkwjd
rkwksmsrjt	rkwOsmsrjt
threhqkdtn	threlqkdtn
dlswowjsfir	dpswowbsfir
rnjsdlrgidtkd	rnjsdlrgidtPd
tlsrhksehdeo	tlsrjksehdeo
dlTsmsrhsrud	dlTsmsrhsrOd
tltmxpawpwh	tltmxpawpwn
qordjqthffntus	qordjqthffbtus
andyddPtnf	abdyddutnf
vkfkgrpqhdl	vlfkgrpqbdl
gksmswndrnrcp	gksmswndrorcp
qnfrytktkd	qnfrPtktkd
qldydrnwh	qldydrywn
wkdtpwjsghks	wjdtpwjsghks
wkdtnwldur	wldtmwldur
thfrhqkdldhapelzkf	thfrhqkdodhaielzkf
tlffurehrkwrh	tlffurehrkwrj
dmsgodehdrudwlwja	dlsgodeodrudwlwja
thskandhkqks	thskandhkqhs
cnscjsqnfryqkdthd	cbscjsqnfrhqkdthd
xhdrPwkrdjq	xhdruwprdjq
qnfqjqdjdjqgoddnl	qOfqnqdjdjqgoddnl
qotkdcordlaqhgja	qotndcordlaqhgpa
eoqnrcjqqh	eoqnrcjqqo
emddmfhghksruddhdua	emddmfhghksrlddydua
ekffjtkdtmd	ekffntkdtmd
gkcjswjdghk	gkcjswjdghn
wkawjdtkdyd	wkawmdtkdyd
tjsrjdlgn	tjsrpdlgp
rnwhdjqan	rnwkdjqan
djrwlcnsgid	djrwlcisgid
dlfdjsqksrn	dlfdjsqmsrn
thsusemfdmlaowkdwkdth	thsusemfdmlaowydwkdth
gkqnrlrhks	gkqnrlrlks
gksrnrrnrdkrguqghl	gksrnrrnrdkrguqgOo
wjdrlrhdco	wPdrlrhdco
smsguseotkdtjs	sysguseotkdtps
wpqkdrhdtk	wkqkdrhdtn
aorudajsl	aorudapsl
ekatndlwjs	eOatndlwis
whdahremfrhkwn	whdahremfrhOwn
zkemeocnf	zOemebcnf
tnfuqghkfehd	tbfuqghkfePd
cnldjqwnsql	cnldjqwnsqO
endkshdhk	endksodhk
zkemruadyd	zkemruadid
emfdmsekth	emfdmsekty
dusqkddmldnjs	dusqkddnldnjs
qkfptdmfchcjdgo	qkfptdmfchcmdgP
whdjqdjwkd	whdjqdjwnd
wmdtldirqkf	wmdtldirqnf
tlalsgkrry	tlapsgkrry
wkehdwnans	wkeydwnans
dhvltmxpf4cmd401gh	dhvltmxpf4cod401gk
rudwprhksrP	rOdwPrhksrP
tjehtjdwkd	tjebtjdwkd
wlwornjswjdtkdghldml	wlwornjswjdtkdghldmO
alwmghvkdlsostufrmfnq	alwighvkdlsostufrnfnq
rksghdjqan	rpsghdhqan
apdlfzmffjq	ahdlfzmffjq
rhkddurthrkr	rhlddurthrkr
shddirwpvna	shddbrwpvPa
tkdptjchltjdghd	tkdpthchltjdghd
duftkrlsua	dmftkrlsua
wldurquddnjs	wldurqPddnjs
dhkghwkdfyd	dhkghwidfyd
aorkrwldnjs	aorirwldnjs
xhddlfdnsehd	xhddlfdnsepd
diekddmldnjs	diekddmldyjs
cjflqkdqjq	cjfbqkdqlq
aneksxnrl	ayeksxmrl
dptjsmswjdtkd	dptlsmswjdtkd
rudrlrhksfka	rodrlrhksfka
gksrufprmfla	gksrufirpfla
anfrkdusehd	aofrkdusehd
ekaqodOrl	ejaqodhrl
wpwnehdutls	wpwhehdutus
vhrfurtjzmf	vhrfnrtjzmf
todrhrfldkv	todrbrfldjv
eoaksrhfvmtkdvna	eiaysrhfvmtkdvna
gksmlqkfka	gksnlqkfka
dlckwdkTdj	dPckwdjTdj
tnwldkrghk	tuwldkrgho
rntjdehlscpwjd	rntjdekjscpwjd
vlffmagudxo	vlffyagudxo
dhlrnrtjstn	dhkrnrtjstn
gksmsepehalvlfgks	gksmsepenalvlfgks
rkddnjswldur	rkddybswldur
altnftprP	altnftprn
rhdgkrtksdjqekswl	ridgkrtlsdjqekswl
vowjsxntn	vowmsxntn
todtksqkswkd	todtksqkswnd
zjstjfxjsem	zjstyfxisem
rltnfguqfur	rmtnfgmqfur
dpsdptmrjscnrtjfrP	dpsdptmrjscnrtjfru
skdkrkrm	skdkrirm
tmxlrmflcm	tmxirmflcm
skatjdeksdnjs	skatjdeksdijs
voddlclrl	vkddlclrl
ryxhdrhksfusqjqrbdnlqks	ryxldrhksfusqjqrbdnlqks
eoxhdfudrhdqhtntjr	eoxhdfudrhdqltntjr
wkwjsrjahf	wuwjsrjahf
dlsfurdmfcjftn	dmsfPrdmfcjftn
wnrkstlsgh	wnrOsthsgh
toakdmfrmarhdkv	toakdmfrmarhdjv
eostmeoghl	eostmeogul
tjdrhkrhksfus	tjdrhkrbksfus
dlfqntmdth	dbfqitmdth
dnpdjwjdvnatkdydahqja	dnpdjwjdvnatkdhdahqja
dpguqwhgksek	dpguqwbgosek
qlTlfkdls	qlTlfkdhs
shddjqrlqksrhdtk	shddkqrlqksrhdtk
dusrmrwpwhwlr	dusrmrwmwhwlr
wntlrdlsjan	wptirdlsjan
tjddnjswnxorgkfqn	tjddnjswPxorgkfqn
cprufrmador	cPrufryador
duaksrkak	duaysrjak
tkagoeofla	tkagoeofua
qntksansghkghlrhks	qntksaPsghkghhrhks
cjstkdnsehd	cjstkdmsehd
dksgsmsekrnrsotnvlfwjstjdcjf	dnsgsmsekrnrsotnvlfwjstjdcjf
qhdlsmsdlehdxhdtls	qhdPsnsdlehdxhdtls
xmfpszmsms	xmfuszmsPs
qicptmffkvm	qjcptmffkvm
wldur18ro	wldur18rn
zhtmekrtlwkdemdfhr	zPtmekrtlwkdemdfhr
eoghlwlrgn	eogllwlrgn
wlqwndrkafl	wlqwbdrmafl
rudrlrkRmxsks	rudrlrkRmxsls
dmsgodgkqqud	dmsgodguqqhd
Rmxekgsmsrmrht	RmxekgsmsrPrht
tkdjqdmfwns	tkduqdmfwns
rmfjgrpehl	rmfjgrpekl
rnrsodbcl	rnrspdbcl
tngoakdmf	tngmaPdmf
dmfvhgkago	dmfvigkagb
ghkswkrkatl	ghbswjrkatl
rhrmqqlffk	rhrmqqjffk
tmvhcmakzpxlddjq	tmvhcmakzixlddjq
tkatksxorwl	tkatksxlrwl
eorntjqn	eorntbqn
dlTeksmswjsakddlqsl	dlTeksOswjsakddlqsl
dlfqntlfldjf	dlfqytlfldjf
xldlstbdjfjstm	xodhstbdjfjstm
alrnrdusqkd	alrurdOsqkd
rudwpruddud	rudwPruddud
qjqdnjsrudao	qjqdnOsrudao
dmlskrvhrcnrth	dmlskrvorcnrtu
qhdksanswp	qPdksanswj
zpdldlTl	zkdldlTl
gpwlvjsemtkdjq	gpwlvjsemtkduq
ektksqjqdlseoflwja	ektksqbqdiseoflwja
dusthrgkfkr	dusturgkfPr
dhlqntkdghkd	dhlqntkdgokd
eogoddPchs	engoddPchs
wlaudrudwod	woaudrudwud
cornjstltmxpa	cornjstltPxpa
gudxodlamfhwoan	gudxodlamfhwban
skgPdbsTl	sOgjdbsTl
wldnjsduqn	wldnksduqn
dnjftmxmflwjsjf	dnjftPxmflwjsnf
gkstoarnrdjwjsansrydbr	gkstoarnrdjwjsansrkdir
eltmzjqjfltkdldjstmcosjf	ebtmzjqjfltkdldjstmcosif
emfdmlrkrquf	emfdhlrkrquf
wkrlwntlrcnlemrtlsxkrrPdir	wkrlwntlrcPlemrtlsxkrrPdir
rpdlatmvkt	rodlatmvkt
djqanvmfhtptm	djqamvmfhtptm
cjsdjrdnjssmfdjskT	cjsdlrdnjssyfdjskT
rmarlfufdnjswn	rmarlfPfdnjswu
qkdthdtjqltm	qkdthdtyqlto
dhlghksdmsgodemd	dhnghksdmsgldemd
ghkswjrghkanf	ghkswjrgpkanf
wowjdthstlf	wywjdtmstlf
wpwnvoszhfldkqhffld	wkwnvoszhfldkqhffld
cprkawltn	cproawutn
skwdkwlrhqus	skwdkwyrhqus
rkdwpwldtnqkddks	rjdwpwldtnqkddbs
tjadbthworltnfroqkf	tjadbtoworltnfroqkf
dhkswjsxhdgkq	dhbswhsxhdgkq
tjryqlfeld	tjryqlfepd
tmfjdnsrk	tmfjdPsri
xnwkwjdcor	xjwkwjdcor
qotjejrkdska	qjtjejrkdsya
rhfemstbwm	rhfemstnwm
gjdydgodkRkqrp	gjdydgodlRkqrp
rkwjdvhrfurcnqkd	rkwjdvorfurcnqkd
gkrtnfghkfehd	gbrtnfghPfehd
djflsayfmf	djfhsaOfmf
akdlslcl	aOdlslcm
qnfvusEoans	qnfvusEoaos
wjstprjfo	wOsthrjfo
rhkeoakdtkd	rjkeoakdtkd
wkcprltnf	wkcprltbf
rhqkftodgn	rPqkftidgn
xhdtlsthffntus	xidtlstiffntus
rndlqqneka	rndmqqheka
dudghkepqnl	dudghPepqnl
gkdntmrkarbf	gjdntmrkarbf
wldurrltnfgurtls	wPdlrrltnfgurtls
tjswjsghktk	toswjsghktk
skaausvkcnfthwkd	skaaosvkcnfthwkd
tjsrjqkdwl	tjsrjqkdwp
dltmqjrm	dOtbqjrm
zkemqnfqjq	zkemqpfqyq
duddjqdnlgja	duddjqdulgja
wjdtlaghkghf	wjdtlaghngPf
shddjqrltnf	syddjqrbtnf
clagogksmsrjt	cOagogksmsrjt
rhfvmvjxld	rofvuvjxld
skfksglruftmd	skfksglroftid
ehrehqkranfrhks	emrehqPranfrhks
ghkfehdeksdnl	gbkfehdeksdnj
tjdnfdusxhd	tjdofdusxhd
ryeochdwkd	ryeocjdwkd
rjatkghkfehd	rjatighifehd
qnekagodirPdir	qnekagkdirPdir
qkrmekemdmf	qlrmeiemdmf
dlemsEkfdl	dleusEkfdn
zmfpcmaj	zjfpcmaj
gkftnehdlTek	gkftnendPTek
thaormadbdwlwja	thaOrmadbdwlwja
gksekrhtjrgkr	gksebrhtjrgkr
dkvdptjwlrwkd	dkvdutjwlrwkd
tjddlstkdlxm	tjddlstidlxm
akdmfvPtn	akdpfvPtn
eoqnfrnrrktksdjqekswl	eoqnfrnrrktpsdjqekswl
ckdlfhapekf	ckdlfoapekf
sjanzjtj	sjabzmtj
wjdqneowjscjdtk	wjdqneowjscjdth
tnfkrdustjf	tnfkrdPstjf
ghdcjsrnrehdbwlrhksfltkanth	ghdcjsrnrehdbwirhksfltkanth
Tkddydghkwo	Tkddydghbwo
wpwngotn	wpwhgotn
gksrnrwlflwjdqh	gksryrwlflwjdqh
xkdns434gh	xkdus434gh
woqjf2tp	woqjf2ty
wjdqnrhksfy	wjdqhrhnsfy
dlTdmaueksansaptlwltjqltm	dlTdmakeosansaptlwltjqltm
rnehrrPdir	rneyrrPdir
tjdnfwldurqhsqn	tjdnfwbdjrqhsqn
wlrtlgkfEo	wlrtlgmfEo
rkaehrrlrhks	rhaehrrlrhks
vndanfansghk	vodanfansghk
dkdlwmghfeldtmdl	dkdlwmghfehdtmdl
wktkwjstl	wktPwjstl
tldptjsmstnsckf	tldptjsmstnscmf
djqrmfpdlem	djqrPfpdlem
didgustmdgksrnrrhkgkr	didgustodgksrmrrhkgkr
dlscjstkdfbr	dlscjstndfbr
alrnrskaqn	airnrskaqO
wlsrudduwnd	wlsruddiwnd
gudtjdehlaustjdlxmfWo	gudtjdehlaustpdmxmfWo
qkesmsrhkdwndmsgod	qkesmsrhkdwPdmsgod
wndeogkstk	wndengkstk
ehekfgksmssi	ehekfgpsmssm
dlTsmsqPstudnwl	dlTshsqPstudnwl
wncprnrals	wncprnrabs
wpqlwlqthtm	wpqlwbqtltm
wjfclsgkstk	wjfclsglstu
tprPrlfhrdmfThe	tprPrlfhrdufThe
wkrkvnawlf	wyrkvnawlf
tjfvjtmvmflddpahdls	tjfvjtkvmflddpaydls
dbdmlwhdahr	dbdmlwjdahr
dkskarjstjfeovy	dkskarjstjfeivb
dmfdnsdudgks	dmfdnsdndgks
qoraktkeks	quraktkeks
tlsrbemdfhrwhdahr	tlsrbemdfprwhdahr
wkdusghksrud	wkdusghksrhd
wlwlxhdtls	wuwlxPdtls
gksqkdquddnjs	gksqkdquddnis
ajswjqkdwltltjf	apswjqkdwlthtjf
alsdmlthql	aysdmlthql
dlstidldixm	dlstidmdnxm
cjqqhdnltjd	cjqqOdiltjd
anfrkqusehdqns	anfrkqjsehdqns
rkdghekdnstlffur	rOdghekdnstlffur
tkdghwkrdyd	tkdgOwkrdyd
dlemfwnqus	dOemfwjqus
dhkchlrudfid	dhkchmrudfhd
rPwhkdlcptjqltm	rPwnkdlcptjqltm
dhkfydtksdptjtlfwhd	dykfydtksdOtjtlfwhd
xovudghkdnl	xovudghldnl
wowjdrudwpdnldnjs	wowjdrudwpdnldpbs
xmrfPdlqgkr	xnrfPdlqgkr
rkatlvudrkrPghlr	rkatlvudrnrPgilr
rnrduddlfrks	rnrduddjfrks
cndcjdskaeh	cndcydskaeh
rhdwjdrjfo	rudwjdrjfo
xntlswktkf	xOthswktkf
thwodjqcp	thwodkqcp
duddnjfwldur	duddnjfwldjr
zhfldkajcjs	zhfldlaucjs
wldhzmfhs	wldhzmfis
fkdpffldks	fkdpffldps
rnrflqwjswkzjavbxj	rnrflqwbswkzjavbxk
fosemtkrks	fosemtkrms
rhdgkddnsdud	rldgkddnsdud
rkdyvmfhrmfoa	rkdyvyfhrmfoa
tkrurrudrl	tkrbrrudrl
Tkfthqlrkath	Tkfthqlrjath
todtksqnsdi	todtksqysdi
wjatnrudwod	wOatirudwod
vmfkselsk	vmfkselsO
wlsksgoakf	wlsysgoakf
rhksrhkdruddud	rhksrhldruddud
cpqnfdlarma	cpqnfdlaroa
dusrmatkdvna	dusrOatkdvba
rudwodrurghk	rmdwodrurgok
rhthrcjfehrhdeks	rhthrcjfenrhdeks
rhdtmqrPghlr	rhdtmqrPghOr
dbxhdwjsansdlsfur	dbxhdwjsansdlsfkr
elwlxjfdudtkdwjwkd	ePwlxjfdudtkdwjwhd
whtjseoqnthr	whtpseoqnthr
todahflcm	tOdahflcm
rnrxhdldydrPghlrqusrud	rnrxhdldydrPghlrqusrjd
vywjddmsahen	vywjddksahen
rkqkdvldpfmrkfmepd	rkqkdvldpfmrOfmepd
cjsdnjsWkfl	cjsdkjsWkfl
ekdidgkstkfPfmf	ekdidgkstkfofmf
shgrhxhfhsgk	sugrhxhfhsgk
ckrhksdmsrmfj	ckrhksdlsrmfj
wlqgodrhkwjd	wlqgodrhkwpd
dkaghgoehr	dkaghguehr
wkdausdmsehdanf	wkdausdmsehdalf
qotkdtlscjd	qotOdthscjd
wpwnehdduwnd	wpwnehdduwid
aleldjrldjq	ameldjrldjq
cjdghkdgodyddhkdgmagid	cpdghkdgodyddhldgmagid
dldjeoghl	dldjemghl
dmlwndrjfltbt	dOlwndrjfltbt
gnqhwldur	gnqmwldur
gkseksmsdOrl	gkseksmsdOrp
tmvptuffltmxm	tmvothffltmxm
qoekdvmffjtm	qoekdvpffOtm
wlausehdaus	wmausehdajs
dbqnqkqdbqn	dbqhqkqdbqn
wpwnwndansghxpf	whwnwndaPsghxpf
dufjtdltj	dufptdltb
gkfkrgksmsemd	gpfkrgksmsepd
doqmsbdml	duqmskdml
gosemalrtj	gnseialrtj
rhkdrhtndlreogoddjqwk	rmkdrhtndlreogoddjqwk
xmrtnwjfehguadml	xjrtnwjfehgkadml
tkausgkfdls	tmausgkfdls
tmakxmzkemrhksfl	tmakxmzkeorhlsfl
wldnjsdmfgown	wudnjsdmfgowj
qkrmekem	qkruekem
wktjrhals	wktjrbais
whrjsdmfaksg	whrjsdkfaksg
rkrndpdlfm	rkrbdpdlfm
rmfjsktlfwp	rmfjsOtlfwp
rhksflwjsakd	rhksflwbsakd
tpfptkdlxm	tpfOtkdlxm
tmtmfhdnjsclr	tmtmfhdnusclr
anrlwpgksguqwjd	anrlwlgksguqwjd
dlfrkadmfckwdmfj	dlfrkadpfckwdkfj
wkddnjsdbxhd	wkddmusdbxhd
durtkcorwnd	durtkcorwmd
wlscnfgoehd	wnscnfgoehd
tkwkddlanffuqkedkTek	tkwkddlanffuqyedyTek
dksgrhekdid	dksgrhebdid
dhsfkdlsdjqcp	dhsfOdlsdjqcp
vmfkdtmqodn	vpfidtmqodn
djejqkdlwjtm	djejqjdjwjtm
wlehahfms	wlehapfms
tntnfyfmfauswpgksek	tntnfyfmfapswpgksek
rmadmsqhghk	rmadmsqhghb
dlwndahrtna	dlwhdamrtna
eotkddjqan	ePtkddjqam
soqnghlrPrhksfl	soqnghlrPrnksfl
wntlrtlwkddldhglfu	wntlrtmwkddldlglfu
rhfueotodaud	rhfpeotodaud
wpdlfwjcnrdmsgod	wpdlfwncnrdmsgod
vkqtmdhzptmxmfj	vkqtmdhzptOxmfj
rkadnjsrbah	rkadnpsrbah
tlscnrdPwjd	tlscnrdywjd
tksgkrrhdehd	tusgkrrhdeOd
flsptktm	flsjtktm
wnakfwkdtp	wnaufwydtp
thdrmagkfuausdhlghkstlwkd	thdrmagyfuausdhlgbkstlwkd
qustksqkseh	qustOsqkseh
tlsrbcncjs	tnsrbcncjs
tkrmfjemfdj	tkrmfmemfdj
thddosjffltmxm	thddusjffltmxm
gkehfhrdbeh	gkemfhrdbeP
tncjssusehddks	tncjssusekddks
rndml3ehd	rndml3eid
dlrmqthrgl	dlrmqtkrgl
antjsdlsxjsptdyrma	aOtpsdlsxjsptdyrma
soqnrjfoqlwnd	soqnrpfoqlwpd
diaktlxk	diamtlxk
emfdjtjfEoakek	emfdutjfEOakek
didtlatjsdjs	didtlatjsdOs
durjsdmfwhtjdgk	dOrjsdmfwhtjdgk
todtkscpwp	tmdtlscpwp
ehddkakfkxhs	enddkakfkxhs
cpfpszksxm	cpfpszhsxP
tlwkdqustn	tlwjdqOstn
fhtmdoswpffptmqjqdnjs	fhtldoswpffptmqjqdnjs
ajrdlfmfwpeo	ajrdlfyfwieo
wlflwjdqhtjqltmwprhd	wyflwjdqhtjqjtmwprhd
rnemfoeorhd	rnemfoeorbd
rnsalswjstks	rnsalswjstus
rjatordjqcp	ryatordjqcn
vudghktkdtntkd	vudgoktkdtbtkd
wjdtlsrPtmd	wjdtlsrytjd
eogksandurxnwkwlsgmdrhdtk	eogksandurxnwjwlsgmdrhdtk
dnlsehdnxp	dnlsekdnxp
dureochlrkd	dureochOrkd
wlwlrlqks	wlwurlqks
qnsdiddbgud	qnsdOddbgud
ekscpwhdahr	ejscpwhdahr
dnsehdtjstn	dusehdtjstn
gltmxhtmxpa	gOtmxhtmxpa
ehlsmsrjfl	ehlsmsrjfu
gmlakddidqls	golakddydqls
whgudcmraus	wbgudcmraus
rhddksrkatl	rhddnsrkatl
tkadudxhdtls	tkadudxpdtls
dnsgkdguqdir	dbsgkdguqdir
ehckrgowjd	ehcnrgowjd
tjdnfelwlxjf	tjdjfelwlxjf
rudrPfmfemfjso	rudrPfmfeifjso
emrdmlqnsqo	eOrdmPqnsqo
rhkgkrthtjf	rhkgkrthtkf
roakrrhddus	roakrrOddns
cordladmfdlswjd	cordladhfdlswjd
ansghkrhksrhkdtltjfrhksfltkdjqth	ansghOrhksrhkdtltjfrhksfitkdjqth
dlqrnrdmfrjqn	dhqrnrdmfrjqu
gksrnrrlchrhkgkrwldnjs	gksrnrrlclrhkgkrwldnjs
snsrlfdmfwkqsms	snsrlfdmfwkqshs
dlfrksdldyd	dlfrisdldnd
aoaoehdgid	aoauehdgld
tlscjdtjfb	tlscPdtjfl
gksrnrtjqltm	gisrnrtjqltj
dlsrlrktn	dosrlrutn
didwkrhksrP	didworhksrP
ekaqodlstkarhd	ekaqodostkarPd
dldlrrhksfl	dldlrrmksfl
tlqrkstlqdlwl	tlqrustyqdlwl
zyvkdlsostuf	zyvkdlsistuf
dldjwlqkdrhdgkdwnd	dldjwlqpdrhdgkdwnd
dnjxjrpdlxm	dkjxjrodlxm
tnghkrguswkd	tngikrguswld
wjdcorwjqahr	widcorwjqahr
dpflrtmsqkrtk	dpflrtusqkrtO
rhkdwnrudtjs	rhkdwnrudtys
rkqkddmfRnal	ryqjddmfRnal
gkrrytjstod	gkrrytPstod
Eofhsmsqhrwkqgk	Eofhsmsqhrwjqgh
rkdskatkatjd	rkdsbatkatjd
ansghkrogur	ansgykrogur
dksehlqslekEh	dksehlqslekEO
duwkvpstld	duwuvpstld
dlstkwkqdma	dlstkwnqdma
tpfmfanffl	tpfmfalffl
chdrhkfwlgnlgodhs	chdrokfwlgllgodhs
rhkgkrgkrtnfekscp	rhkgkrgkrtpfePscp
chlekvksao	chhekvksaP
tlgjatjqltm	tlgjatPqltk
tkckfeksqhrrnl	tkckfeksqhrrni
dmsgoddlskzkem	dusgoddlsuzkem
duwktldrmf	duwotldrmf
qksehcpapdlzj	qksehcpaldyzj
tmzlxmdmlqkr	tmzlxmdilqkr
rnralstodghkfcpdbrguqdml	rnralstodghkfcpdbrguqdPk
ehdgotkacjr	ehdgotlacjr
wjrqksgkwkd	wjrqpsglwkd
tndlqdlsel	tkdhqdlsel
rnswkdrnrrktksdjq	riswkdrnrrktpsdjq
tjstnchsdmsrkftnfhr	tjstnchsdmsrkftPfhr
wltks2ehdwkd	wytks2eydwkd
rmsqhscnlwl	rmsqmscnkwl
qhdthogksmsrjtrhk	qhdthugksmsrjtrhk
dlavlejstm	doavlejstm
tjsrufanswp	tisrufalswp
gksrnrtkgkr	gPsrnrtkgkr
goekdwldurdpdlfwjd	goekdwldurdidlfwPd
snqkxlarhk	sPqOxlarhk
ghkrqhgksenl	ghkrqhgksejl
vlfdygksrufwjd	vlfdPgksrOfwjd
dnlgowjsrltkdyd	dnlgowjsrltldyd
dydvnaghltk	dydvnagultk
shtkanswp	shtpanswh
soahffkfk	soahffofk
ahshemfkak	ajshemfkak
spxmdnjzmdjThtldpdlcm	spxmdnjzmdjThtjdpdlcb
dkstjdtlflq	dkstidtlflq
cjfsuxkdhfnsk	cnfsuxkdhfnsm
vmflwmaqpscj	vmflwmaquscj
soqnxhdwp	soqnxmdwu
vlgodigkseksmsrp	vlgodigkseksosrh
rbauddldlfnjwu	rbauddldlfyjwu
cjdcnfdjfka	cjdcOfdifka
wndtlawldpdnlclgk	wodtlawldpdnoclgk
tntorwkrdjq	tntPrwkrdjq
ghkfehdqjadnl	ghkfehdqjadnP
wjdrbdnjfem	wjdrpdnjfem
tngorhdehd	tnglrhdehd
zjaekrxj119	zjaeorxj119
ehddmlfmfdjedj	ehddOlfmfdjedj
dkxpspdhfflavlr	dixpspdnfflavlr
rkrwhddmlghr	rkrwhddmPgur
wnfdlrhtkcodjq	wnfdlrPtkcodjq
wjsdpsoshkTdj	wjsdpsoshiTdj
audfkdtjsql	audfkdtksqj
qhdtkwhdgkq	qhdtywhdgkq
Tlsmschkfdud	Tlsmschkfdyd
vPdlstlrrl	vPdlstOrrl
wkdbfruddud	widbfruddud
dptmdkdlxpzm	dptPdkdhxpzm
dlfqhsxkrrn	dufqhsxkrrn
rbsguddPtks	rbsguddbtks
skwdkwlftn	skwdlwlftn
vhxhvmflsxj	vhxhvuflsxP
thdtkschemdgkrry	thdtkscheOdgkrry
djfudnsrhtemfdl	dmfudnsritemfdl
ansdPckdwkr	ansdockdwkr
cnrkskrvhr	cnrksurvhr
didtkseogkrry	didtuseogorry
xldjemqkdl	xldjeoqkdl
qudtksthdwjscjfxkqtjfcl	qndtksthdwjscjfxkqtjfcu
tlemsldhfflavlrdlgn	tlensldhfflavlrdlgn
dmlfltjdcjf	dmlflthdchf
vkffuqnsdid	voffuqnsdid
tkdjqsodyd	todjqsodyd
ehfhrhdtkdptjdmsxhlgks	ehfhrhdtkdptjdpsxhlgks
qnwjstlwkd	qpwjstlwkd
wlqnscjqnsgn	wnqnscjqnsgj
akclsxladl	aiclsxladl
qkRdmfhqhsorh	qiRdyfhqhsorh
tkghldnsehddusrnthwkd	tkghldnsehddisrntOwkd
wjsansroqkf	wbsansroqkf
tkdvnadmfqjfu	tkdvnadmfqhfu
tkemfdmlwpgbrk	tkemfdylwpgbrk
rkdnsepgbaortm	rbdnsepgbaorth
qhqltmfpsemfltm	qhqltmfpseufOtm
rhksdmaqhtkf	rhksdlaqhtkf
fhemflrptm	fhemfirptm
gksmsdlaan	gksusdlaan
cndqnrandyd	codqnraPdyd
akfndnsehdrudrl	akfodnsehdrudrl
dhlrnrthssla	dhlrnrtyssla
glffldjemfkdl	glffldjejfkdp
xmrtnrydbrwlsgmdqjq	xmrtnrydbrwisgmdqjq
skdhawlrgks	sidhawlrgks
wjsakddlgkgid	wjsakddigkgid
gksmszofha	gbsmszofha
wjsfurtksdjqrlqksrlrma	wpsfurtksdjqrlqksrlrma
wkdirhvkf	wkdirhvpf
qorwpansghkdmldjf	qorwpansglkdmldjf
Rhcqkeclaxhd	Rhcqkecyaxkd
wndemdtksghk	wOdemdtksghk
clfytkdls	clfmtPdls
vlffkepfvldkqksehcp	vlffiepfvldjqksehcp
flrmcnrrn	firmcnrrn
rnrwprmadbddusrntpsxk	rnrwprPadbddusrntpsxk
gksekfdudkvenrh	gkseofdbdkvenrh
wpwnehghl	wpwnehghm
emfdmsdbrhkdtjr	ebfdmsdbrhkdtjr
wnddjwndans	wnddnwndans
qnrkrlsmd	qhrkrOsmd
wlqnfqhwmd	wlqnfqowmd
wlqkddmsgod	wlquddmsgkd
fkdlstlspak	fkdjstlsiak
ehorkskgodnstkdhk	ehjrkskgodnstkdhk
rhfemcc	rpfemcc
altmxpfl	altmxOfl
wksduanfdlskawl	wksduanfdpsbawl
eogksalsrnrrhdrns	eugOsalsrnrrhdrns
gksdncoRmx	gksdnckRmx
ghksrudwkdnjs	ghksrkdwkdnjs
gksrnrqnstjrrlrl	gisrnrqnstyrrlrl
vpfmsksehqkrktm	vpfksksehqirktm
quddurxmrfP	quddirxmrfP
dnjssoeocorghldml	dnissoeocorghldmy
whqudgmltkwkd	wPqudgmltkwyd
wlswjdgkschlrkdwkfh	wlswjdgkschprkdwkfh
ansghkfmfaksemfdj	ansgpkfmfaosemfdj
ehdlqqldyd	ehdyqqldyd
dnjsahrtkdxo	dnhsahrtkdxo
tkdghkssmdfur	tkdglkssmdfhr
xhdghkeksdnl	xPdghkeksdnl
dksdmfrlghlr	dPsdmfrlghlr
tlftkrlrksehddks	tlftkrlrksehddos
wnxorrhdrks	wnxmrrhdrks
dltkdcjstjs	dltkdcustjs
glrktldlclzldur	glrntldlckzldur
ghskarhthr	ghskarhtkr
ckadutlscjd	ckadutnscjd
gmltodwktn	gmltodwptn
fhajrducls	fyajrducls
dmfshsdmlgk	dmfsksdmlgk
tmxkrhkdgkr	tuxkrhkdgkr
ckdflqcnlwlans	cPdflqcnlwlais
rudwpxmrrngusdks	rudwpxmrrngusdPs
gkfkrdmfdlfwjdqnqns	gkfkrdmfdlfwldqpqns
wjsrnrcnrrneoghl	wjsrnrcPrrneoghi
wjrcnldirtjd	wjrcnldirthd
sbdpsxlzlaghdrk	sbdusxlzlaghdrk
gkqqudrPghlr	gkqqudrPgulr
gkwlaksskctjs	guwlaksskctjs
ghlrPtjfclalc	ghlrPtjfclabc
dlscnftkxo	dlschftkxo
cjdtksanffid	cidtksanffid
rpdlxmdnp	rpdlxhdnp
qnekdguadml	quekdguadml
tkdfhrghxpf	tPdfhrghxmf
xpfktmxpzmshffjwl	xpfotmxpzmsjffjwl
rldjqdusrmawpeh	rhdjqdusrmawpem
tprPfmfshffkrp	tprPfmfspffkrj
coaqjdhzptmxm	claqjdhzotmxm
cjswjdzmfpdls	cjswidzmfbdls
rltnfdlwjsryfbtpsxj	rntkfdlwjsryfbtpsxj
qjqwjdrmsfh	qPqwjdrysfh
ehlsekauguseotkd	ehlsekaugusejtkd
rkqnfrksmd	riqnfrksmd
qkdldhqpscjrldjqwldnjstpsxj	qkdldhqpscjrldjqwldnPstpsxj
rlfmadbcnf	rOfiadbcnf
zhfldkgkdlxpr	zhfldkgkdlxnr
gksrkdtnrPwldur	gisrkdtnrPwldur
dudskadlfqh	dudskadpfqb
rhqnfchdfla	rhqbfchdfha
cnfvksqneks	cnfvnsqneks
tlatktmdwls	tPatktjdwls
audtlagjrjTrnaksdy	audtlagjrjTroaksdy
skdltmxmfptm	skdltkxmfptP
zpdldptm	zpdldptl
tnqorauddp	tnqoraoddp
rhfemakstkrtm	rofemakstkrtm
rmfhdnpfwjswk	rmfhdnyfwjswk
cjfqurqneo	cjfqurqnen
smffutodtks	smffltodtks
gksaldufflsrltnf	gmsaldufflsrltlf
aharkqtEkdzhd	aharkqtEldzhd
tlrlfmfshgcl	tlrofmfspgcl
skatjddmlfb	spatjddmlfj
dbwlsrhksrhkd	dbwlsrhpsrhkd
wndwjwidtjd	wndwjwjdtid
qkfvydlgn	qkfvydlgy
tjswjsdidh	tOswjsdldh
xovudtleo	xovodtleo
dhlrhkrwhwlr	dmlrhkrwhwlr
rjstjfdmldk	rlstjfdmldk
dlsrksqhrwpghltk	dhsrksqhrwpghltk
rygkqwkddosk	rygkqwkddpsm
rudwpxhdrPwkfy	rudwpxhdrPwkfp
ekffjtjsanf	euffjtjsanf
ehddlfwjavh	ehddifwjavh
ruddndlqjswn	ruddldlqjswn
ekffjqnwhr	ePffbqnwhr
qnstkstlzlsmfkwlsEka	qnsthstlzusmfkwlsEka
rnsdlsdutjd	rnsdlsdutyd
worPchdtn	worPchdtk
tlfwhddkehd	tlfwmddkend
cpdbrtkdjq	cOdyrtkdjq
rlqkstltjfrhdtk	rlqostltifrhdtk
zhemqnsgkfekwndwjqthr	zhemqnsgkfekwydwjqtor
gksrnrwjdqhqhghtncnfwlsgmd	gksrnrwjdqhqhghtucnfwlsgmd
dkzbxprqksehcp	dkzbxprqksepcp
rkadkapclrl	rkadkakclrl
ghksaorhkwjd	goksaorhkwjd
wjsdydrnwkd	wusdydrnwkd
wpwntlcjd	wpwntbcjd
tkanrlrl	tkaorlrp
vlxkfkdnsem	vlxjfpdnsem
tlvdmsrjtdms	tlvdlsrhtdms
vktksdlfks	vytksdlfks
ansdidgorud	ansdidgorOd
dhtkddydrlwk	dhtoddydrlwb
dosltmxhs	dosltyxhs
tkdhldltk1dls	tkdhldltk1dms
ehdansfhxjfl	ehdapsfhxjfl
ryxhdqhwh	ryxhdqhwb
dusrlgosoT	dusrlgosyT
ekslsmszjavbxj	ekslsmszlavlxj
qpxpfkdqusghtk	qpxofkdqusghtk
rkrwhdwhghl	rkrwhdwyghl
qkseoeocordnl	qksejeocordnl
ehdntmdgk	endntmdgk
tlrlwhwjdrnjsrh	tlrlwhwjdrnjsrj
tkdrkdnsdud	tkdrkdksdmd
akzmwpeh	ayzmwyeh
dptjehrhksgodtkd	dmtjehrhksgodtkd
rochldPwjd	rochkdPwyd
ehthaoel	ehtmaoel
aksemsrhdehd	aksemsrPdehd
tjddnjsrjstjf	tjddnisrjstkf
tkdntmzofhffk	tkdntPzjfhffk
tjdnftkanth	tjdnftOauth
qnrgkstjvhxjtm	qOrgkstjvhxjtm
cnldjqqlwk	cnldjqqiwk
tjqltmrlrhks	tjqhtmrlrhks
wlqnsthdb	wiqnsthdb
ausekarhkwjd	auseParhkwjd
dlgodksrk	dkgodksry
qnrhkqkdcla	qnrkkqhdcla
cnrkrudwjd	cnrnrOdwjd
fhRnfuwls	foRnfiwls
rlarbstjqtjs	rOarjstjqtjs
wjdanswjdqh	wjdapswjdqP
cjrcnrmsdua	cnrcnrmsdma
dlsxjelwkdls	dlsxuelwkdls
xpzmsltus	xpzislths
alstnstlsTl	aostnstlsTl
rmffhqjfwhwlr	rbffhqjfwhwlr
ghkdlxmgpem	ghhdlxmgmem
qhffldduwk3dlswhd	qhffldduwk3djswhd
qntksapflshfquddnjs	qntksapflslfqkddnjs
fkdqkdxkdl	fkdqPdxpdl
wjdqhxhdtlstksdjqguqghl	wmdqhxydtlstksdjqguqghl
dydtlschemdgkrry	dldtlschemdgkrry
rktmdjqwhd	rmtmdjqwud
tpqjqrowjddpqksdud	tpqjqrowjddpqksdhd
chrhkrmsan	chrmkrmsan
zksnwhdahr	zksnwidahr
Ekfmsshtkguq	Ehfmsshtkguq
tlatkeotkd	tlatOeytkd
rjenaughkdtjd	rmenaughkdtjd
dldjakfus	dldPakfos
Qoshgdmftn	Qlshgdmftn
wodlfalseks	wodlfauseks
tkdlsdpdj	tkdlsdkdo
aodlqgksdhlghk	aodlqgOsdhlghk
dlepdhffmrl	dlepdhffmrh
qlsrhsxkfcnf	qbsrhsxkfcnf
rudwprydbrwkfy	rudwprydbrwkfP
vPwlrufwjd	vlwlrufwjd
tlfwlrgksgn	tnfwlrgksgp
tjdrhkwldur	tPdrhkwmdur
dlcjscnftls	dlcjscbftls
qpscjzhfldkqpscj	qlschzhfldkqpscj
todghkfcpdbrqnsdi	todghkfcudbrqnsdm
thrgytjdrudrndyd	thrgPtjdrudridyd
qnrtjdusqkd	qjrtjdusqkd
cndwntprPantnfcnrwpcnwls	cpdwntprPantnfcprwpcnwls
eogkswjsansrjstjf	eogkswmsaosrjstjf
dnjsdpskrckfqkedkT	dnisdpskrckfqmedkT
rudwptjdwkdfbfdlwlsksgo	rudwitjdwkdfbfdlwmsksgo
tnwjdchemd	tmwjdcpemd
dudghkqormq	dudghkqbrmq
tjdrhdeoghl	tkdrhdebghl
cothtksdjq	cotOtksdjq
dmfryaygl	dmfryapgl
rjwlttlsghk	rjwlttlsgym
emdtkswhRl	emdtkswhRm
gkrheocnf	gkrhemcPf
xlaehrmaapekf	xlaePrmaapeyf
rkaehrdlgk	rkaeurdlgk
rladhkstjqTl	rladykstjqTl
rladlrwlsrl	rladlrwlsri
zoavlddydvna	zoavoddydvna
