wjdrkdlsaor	wdrkdlsar
wkqwlrhkdrh	wkqwlrhkdrh
whtpqneka	whtpqnea
dhglfudbgo	dhglubgo
qhfnspdh	qhnpdh
wjtrkfrlacl	wtrkfrlacl
tkatjdghkwo	tkatjdghkwo
wkehdckrhddjqguqehdwhgkq	kehckrhddjqguqehdwhgkq
djqthemfdlsmf	dqhemfdlsmf
flghrhksrhkd	flghrhksrhd
whdgkqqhrwlghlrhks	whdgkqqrwlghlrhs
rnralsdlaeo	rnralsaeo
qkrekfskan	qkrfskan
dmaqksrPdir	dmqksrPdir
qksdlghlckd	qksdlghckd
rkwkdrlrks	rkwdrlks
alswnxntk	alswnxtk
gkqslekchlwhd	gkqslekcwhd
rlawngusrlwk	awngusrlwk
gkfkrqkdgid	gkfrqkdgid
dbtkdwmdwkgn	dbtkdwmdkgn
xhdghksodur	xhdghsodur
ghksdbfwjdcor	ghksdbfwjcor
tkavhxpzm	kavhpzm
ahxjtmakxm	ahxjtmakxm
tltmxparkaflguqghl	tltmxparkflguqghl
Eoansdpgodhl	oasdpgodhl
wltlreoruf	ltlreoruf
qlcjfrmathrwn	qlcjfrahrwn
xhdwmddmlgkr	xhdddmlgkr
rldjqqldyd	rldjqqldyd
ehtksdjqan	ehtksjqan
durtlrjxahtmq	dutlrjxahtmq
fhalddlfks	fhaddlfks
qkddjtneks	qkdjteks
vustjdrnrwkd	vustjdrnrwd
anffiddldb	anffiddldb
gjrktlscjd	gjrtlscjd
rhdtldkqls	rdtlkqls
wjsrnrdjsfhs	wsrnrjsfhs
tjehwndrnr	jehndrnr
cptlsdjqan	cptsdjqan
chqheksrP	chqheksrP
rlwlrjstjf	rwlrjstjf
qntlagodhkTdm	qtlagodhkTdm
dhlghkdPrma	dhlghkdPrma
shtnpdlwls	shtnpdlws
rkdgkanfwlf	rkdgkanfwlf
gksrnrduwkvmfhrhfvmguqghl	gksrnrduwkvmhrhfvmguqghl
fmfEjqkecl	mfjqkecl
dlstkqorud	lstkorud
sofurksmsemd	sofurksmemd
wkdsotprbs	wkdsotprbs
rmqducprProvus	rmqduprrovus
akzptdlsdpdlqmffj	akzptdsdpdqmffj
qkseodufhs	qseoduhs
dmfhdlfrhks	dmfhlfrks
eotkdvnaahr	eokdvnahr
qntksrnejrwn	qntsrnjrwn
dmlghrqnqns	dmlghqnqns
tntlqsusrks	tntqssrks
qnekddldlr	qnekddldr
tksdjqrltnf	tksjqltnf
rltnfgurtlstpsxj	rltnfgurtlstpxj
eoehdquddnjs	eoehdqudnjs
wjdqhwnrnjs	wjdqhwrnjs
vhrxkswpwh	vhrswpwh
vhrqkfwlrwjs	vhrqwlrwjs
rytnemfdmlshf	rytemfdmlshf
shsusrnjsdlrqhgh	hssrnjsdlrqhgh
toddjqdmfRnfurkf	toddqdmfRnfukf
vjsemrmfnq	vjsemrmfnq
akdaudrlrks	akdaudrlrs
wkrmaskwwka	wkrmaskwwa
rmsangkejsghltk	rmsangkejsghltk
dlsxjsptqodzm	dlsxjsptqodzm
dlfqnqksqkf	dlfqqksqkf
rnstkqjqdnjs	rnskqjqdnjs
xkwlrltmxks	xklrltmxks
wjsekdfltkdlxmfghf	wjskdfltkdlxmfgf
qnvnarldjq	qnvarldjq
dlTsmstlso	dlTsmstlso
rlsmdeogkrwkd	rlsmdeogkrwd
rhksrhkddnldnjs	rhsrhkdnldnjs
wpgksgoddnl	wgksgoddnl
rjatordlghkfrl	ratordlghkfrl
vkfrhdskswkd	vkfrhdsswkd
xhdwkddlswk	xhwkddlswk
cowjasodur	cowjasdur
gkqdml29qn	gkqdml29qn
wjsdjwkqdl	wjsdjwkqdl
dlfmfqhrh	dlfmfqrh
skantwhrkr	skantrkr
govlqjtm	gvlqjtm
tjswlsrmadbdrlqjqdmfhanwkdgk	tjswlsrmadbdlqjqdmfhawkdgk
dbfjqwnddkd	dbfjqwnddd
zofhffkdlskwn	zofhffkdskwn
fpwjwnxorrhdrks	fpwwnxorrhdrks
ruddudgurtlsdpswls	rudddgurtlsdswls
rkrwhddkswjs	rkrhddksjs
rydbrqhsqn	rybrhsqn
rjtdmfhqhsms	rjtdmfqhsms
aorwngkswks	aorwngkwks
rydbrgbwlr	rydgbwlr
dldjrkftndlT	ldjrkfndlT
tkatjdwjswkelwlxjf	tkatjdwwkelwlxjf
tkcothrkr	tkcotrkr
roffjfldptjduffls	roffjfldptjffls
rlawptkfy	rawtkfy
dmfdmlalgk	dmfdmlagk
wlansdlstlrtltmxpa	wlansdltlrtltmxpa
qkddjwjsfir	kddjwjfir
ghkrwjdgoshg	ghkrwdgoshg
guswltkdghkd	uswlkdghkd
rudwodrhkwjd	rudworhkwjd
skxkskTdmaudlsms	skxkskTdmulsms
duwkxkrrn	uwkxkrn
ekszkswltn	kzkswltn
tkackdvmfkwkqlfeldqptmxm	tkacdvmfkwkqlfeldqptmxm
rhltksrnscjd	rhtksrnscjd
rhdrmqworo	rhrmqworo
ehzbajsxm	ehbasxm
dptjwkwn	dptjwkwn
ansjwusofls	ansjwusofls
dugodrPdir	dugodrPdr
emfdjtjsshgn	mfdjtjssgn
cjsehrywnddkd	cjsehrywnddkd
eofbrghldeks	ofbghldeks
dnfltkwnwhgkq	dnfltkwwhgkq
qnrgkscpwp	nrgscpwp
wmdtkswkrdjq	wmdtkwkrdjq
qustlsgksmsepgksahrt	qustlsgsmsepgksahrt
tkdjqwjsfirdm	tkdjqwjsfirdm
Ektjdirtp	Ektjditp
xhdghktltmxpa	xdghktltmxpa
gkswkrjawjdsmdfur	gkswkrjawjdsmdfur
dnthddPtnf	dnthdPtnf
wlrwjqwhekf	lrwjqhekf
tmdflfmfrjenjTtmqsl	tmdflfmfrjenjTtmqsl
elwlxjfaleldjekswl	elwlxjfaleldjekswl
dlstkarhdtk	dlstarhdtk
rhksflqnsdi	rhksflqsdi
wjdekdaudqn	wdekdaudqn
ehrrkadPqkd	ehrrkadqkd
duwkqorn	dukorn
rlaTlrkdl	raTlrdl
rhkrcndgheowjstjqn	rhkrcndgheowjstjqn
wpwkrgoqntksdktldks	wpwkrgoqntksdtldks
dlTsmsrnaowkrma	dlTsmrnaowkrma
vudrbssowo	vdrssowo
worhwktks	wrhwktks
guseovpdlsxm	guseovpdlsxm
ruddusaneo	ruddsaneo
rudrPtkdxo	rrPtkdxo
vusdlthro	vusdltro
wlqnstmdhkvmanswp	wlqstmdhkvanswp
rhrmqwpvna	rhrmqpna
enlttlaqnwhr	enttlaqnwhr
sbtmtkqjqwpwjd	sbtmtkqjqwpjd
wjdrmawhwjsan	wjdrmawwjsan
fkdntbvp	fkdtbvp
rkftnfhrrjtpwl	rkftnfhrrjtpwl
dkfxkflan	dkfxkflan
dkfmwpsxh	dkfmwxh
wjsskashddjq	wjssashddjq
qncofmftmdrP	qncofmftmdrP
ansghkdudtkd	nsghkdudkd
xkgoddlcp	kgodlcp
eodhldltk	eodhlltk
rhrordjqcp	rhorjqcp
ekfdhfmarmrwkd	ekdhfmarmrwkd
fhcjscjsgl	fhcjsjgl
dlfthsdlqnwhrgowls	dlfthsdlqnwhrgowls
wnxordmstjdnf	wnxordstjnf
rmsrjfhtka	rsrjftka
dnswjsausgj	dnswjausgj
wmdwkfmfdnlgo	wdwkfmfdngo
dhqxhaowlr	dqxhaowlr
dnlrlfmfakwrh	dnlrlfmfakrh
alsthrakdmfcnwlswnsql	alsthradmfcnwlswnsql
wjsrnrduddjdndqus	wsrnrduddjdndqus
emfdprpdidqls	emfdprdidqls
skadnjswldur	sadnjswdur
dlTsmsfhdif	dlTsmsfdif
rlaTlrkwnwkd	laTlrkwwkd
ckwdkrksmsrhkwjd	cwdkrksmrhkwjd
dPtksrbah	dPtksrbah
durqoduftkdxorkrkf	durqoduftkdxorkkf
xnwkwjrrma	nwkwjrrma
tmzkdnxm	tmzkdnxm
rkdwhdrnrlwk	rkddrnrlwk
eowjsguqwjd	eowjguqwjd
tjdvnawjsekf	tdvnawjsekf
ckddjqchrl	ckddjqchrl
tkawjdwndn	tkawjdwndn
tlsehdrhddjq	tlsehdrhddjq
qhrrnqldyd	qhrrnqldd
gkdlxprdmswnrkdkswjd	gkdlxrdmswnrkdkswjd
dnjtldxjseogkr	dnjtldxjseor
qhghwhcl	qghwhcl
zhsptdnjfem	zhsptdnem
rmarkdwpghk	rmrkdwpghk
dlaskdlfqhsqntjf	dlaskdlfqsqntjf
dbqordbTl	dbqorTl
tkdydgodh	tkdydgodh
dbaudgodks	dbadgodks
gudtkdjqxlawkd	gudtkdjqxlawkd
gmlfhdofkr	gmlfdofkr
tpdlqtpcnfruftks	tpdlqtpcnfruftks
dnfuroqhd	nfuroqd
ehdcndgkch	hdcndgkch
wnddyalsthr	wnddyashr
dPwjddlrks	dPwdlrks
tkdghkddmsdlemf	tdghkddmslemf
rmflsfkqpf	rmflfkqpf
dnwlswhdgkqrjstjf	dnwlswhdgqrjstjf
fmfdlxkfgkrj	fmflxfgkrj
wjdtkdcnfrms	wjdtkdcrms
wktlsrkadmfrkwrh	wktlsradmfrkwrh
cjdsusdlsrn	cjdsusdlrn
thrduvksaogk	thrduksagk
dhthdrnrwpqkdldhgkrtnfeoghl	dhthdrnrwqkdldhgkrtnfeoghl
ckfidwmdwjd	ckfidwdwjd
tjsrudandur	tjsrudandr
eoanstlwkd	eoastlwkd
xodjskwlswntkqja	xodjskwlswntkqa
wjdqnwhdgkq	wjdnwhdgq
ckdflqwkans	ckdqwkans
rnrwpguqfurdmsgod	rrwpguqfurdmsgod
dnfldmsgodruddud	dnflsgodruddud
dhgn3tl20qns	dhg3t20qns
tprP22dnl	tprP22dnl
eoaksdlfqhs	eoaksdfqhs
qhrhksxhfhrgo	qhrhsxhfhrgo
wlsksgoqpdlwlddbslqjtldkemduwk	wlsksgoqpdlwlddbsqjtldkemduwk
wkdrlxorqodnsthdrPdir	wkdrlxorqodnstdrPdir
wjsqnrehghl	wsqnrehghl
wnalsvusdlrtltjf	nalsvusdlrtljf
aleldjvmffpdldj9	aleldjvmffpdldj9
tlsdydqlfeld	tlsdydqfeld
tlsdlfqhstksdjq	tlslqhstksdjq
xotjddlshxprdnjfem	xotjddlshxprdnjem
qhrhksckdrhghkwo	qhrksckrhghkwo
rhdrhfmfghkrdlsgksenl	rhdrhfmghkrdlsgksenl
dksgrhdlTdmsk	dksgrhdlTdmsk
ekdlsoalr	ekdlsoalr
rlaehtnfTldlswl	rlahtfTldlswl
qkfrnfrhkwjd	kfrnfrhkwjd
rkwksmsrjt	rkwsmsrjt
threhqkdtn	trehqkdtn
dlswowjsfir	dlswowjsfir
rnjsdlrgidtkd	rnjsdrgidtkd
tlsrhksehdeo	tlsrhkseheo
dlTsmsrhsrud	dlTssrhsrd
tltmxpawpwh	ltmxpwpwh
qordjqthffntus	qordqhffntus
andyddPtnf	andyddtnf
vkfkgrpqhdl	vfkgrpqhdl
gksmswndrnrcp	gksswndrnrcp
qnfrytktkd	qnrytktkd
qldydrnwh	qldydrnwh
wkdtpwjsghks	wkdtpjsghs
wkdtnwldur	wkdtwldur
thfrhqkdldhapelzkf	thfrqkdldhapelzkf
tlffurehrkwrh	tlfurehrkwrh
dmsgodehdrudwlwja	dsodehdrudwlwja
thskandhkqks	thskadhkqks
cnscjsqnfryqkdthd	cnscjsqnfryqkdthd
xhdrPwkrdjq	hdrPkrdjq
qnfqjqdjdjqgoddnl	nfqjqdjdqgoddnl
qotkdcordlaqhgja	qotkdcordaqhgja
eoqnrcjqqh	eoqnrqqh
emddmfhghksruddhdua	emdmfhghksrddhdua
ekffjtkdtmd	kffjtdtmd
gkcjswjdghk	kcjswdghk
wkawjdtkdyd	wkawjdkyd
tjsrjdlgn	tjrjdlgn
rnwhdjqan	rnwhjqan
djrwlcnsgid	djrwcnsgid
dlfdjsqksrn	dlfdjsqksrn
thsusemfdmlaowkdwkdth	thsusemfdmaowkdwkdth
gkqnrlrhks	kqnrlrks
gksrnrrnrdkrguqghl	gksnrnrdkrguqghl
wjdrlrhdco	jdlrhdco
smsguseotkdtjs	smguseotkdtjs
wpqkdrhdtk	wqkdrhdtk
aorudajsl	aorudasl
ekatndlwjs	ekatnwjs
whdahremfrhkwn	whdahrmfrkwn
zkemeocnf	zkeeocnf
tnfuqghkfehd	tnfuqghkehd
cnldjqwnsql	cnldjwnsql
endkshdhk	enkshdhk
zkemruadyd	zemruadyd
emfdmsekth	emfdsekth
dusqkddmldnjs	dsqkddmldnjs
qkfptdmfchcjdgo	qkfptdfccjdgo
whdjqdjwkd	whdjqdjwkd
wmdtldirqkf	wmdtldiqkf
tlalsgkrry	tlaskrry
wkehdwnans	wkehdnns
dhvltmxpf4cmd401gh	hltmxpf4cmd401gh
rudwprhksrP	rudrhksrP
tjehtjdwkd	tjehtjwkd
wlwornjswjdtkdghldml	wlwornjswjdkghldml
alwmghvkdlsostufrmfnq	alwmghvkdlsostfrmfnq
rksghdjqan	rksghdjan
apdlfzmffjq	apdlzmffjq
rhkddurthrkr	rhkddurthrkr
shddirwpvna	shddirwpvna
tkdptjchltjdghd	tkdptjchltjdgd
duftkrlsua	duftkrlsa
wldurquddnjs	wldurquddjs
dhkghwkdfyd	dhkghwkdfyd
aorkrwldnjs	aorkrwlds
xhddlfdnsehd	xhddfdnsehd
diekddmldnjs	ekddmldnjs
cjflqkdqjq	cjflqkdqjq
aneksxnrl	aneksxrl
dptjsmswjdtkd	ptjsmswjdtd
rudrlrhksfka	rdrlrhksfka
gksrufprmfla	gksrufprfla
anfrkdusehd	anfrkdusehd
ekaqodOrl	ekqodOrl
wpwnehdutls	wwnehdutls
vhrfurtjzmf	vhrfurtjzmf
todrhrfldkv	todrhrfdkv
eoaksrhfvmtkdvna	eoaksrhfvmtkdvna
gksmlqkfka	gksmlqkfka
dlckwdkTdj	dckwdkTdj
tnwldkrghk	nwdkrghk
rntjdehlscpwjd	rntjdehlspwjd
vlffmagudxo	vlffmaguxo
dhlrnrtjstn	dhlrnrtjstn
gksmsepehalvlfgks	gksmsepehalvlfgs
rkddnjswldur	rkddnjswldur
altnftprP	altnftprP
rhdgkrtksdjqekswl	rhdgkrtsdjqeswl
vowjsxntn	vowjsxntn
todtksqkswkd	todtksqkswd
zjstjfxjsem	zjstjfxjsem
rltnfguqfur	rltnfgqfur
dpsdptmrjscnrtjfrP	dpdptmrjscnrtjfrP
skdkrkrm	dkrkrm
tmxlrmflcm	mxlrmlcm
skatjdeksdnjs	skatjdeksdns
voddlclrl	vddlclrl
ryxhdrhksfusqjqrbdnlqks	ryxhdrhsfusqjqrbdlqks
eoxhdfudrhdqhtntjr	eoxdfudrhdqhtntjr
wkwjsrjahf	kwjsrjhf
dlsfurdmfcjftn	lsfurdmfcftn
wnrkstlsgh	nrkstlgh
toakdmfrmarhdkv	toakdmfrmarhdkv
eostmeoghl	estmeoghl
tjdrhkrhksfus	tjdrhrhksfus
dlfqntmdth	dlfqntmth
dnpdjwjdvnatkdydahqja	dnpdjwjdvnatdydahqja
dpguqwhgksek	pguqwgksek
qlTlfkdls	qTlfkdls
shddjqrlqksrhdtk	shdjqrlqksrdtk
dusrmrwpwhwlr	dusrmrwpwhwlr
wntlrdlsjan	wntlrdlsan
tjddnjswnxorgkfqn	tjddnjswnxorgkqn
cprufrmador	cprfrmador
duaksrkak	uaksrak
tkagoeofla	kageofla
qntksansghkghlrhks	qntsansghkghlrhks
cjstkdnsehd	cstkdnsed
dksgsmsekrnrsotnvlfwjstjdcjf	dksgsmsekrnrsotnvlfwjstdcjf
qhdlsmsdlehdxhdtls	qhdlsmsdlehxhdtls
xmfpszmsms	xmfpszmsms
qicptmffkvm	icptffkvm
wldur18ro	wld18ro
zhtmekrtlwkdemdfhr	zhmekrtlwdemdfhr
eoghlwlrgn	eogwlrgn
wlqwndrkafl	wlwndrkafl
rudrlrkRmxsks	rudrlrkmxsks
dmsgodgkqqud	dmsgdkqqud
Rmxekgsmsrmrht	Rmxekgsmsrmrt
tkdjqdmfwns	tkdjqdmfws
rmfjgrpehl	rmfgpehl
rnrsodbcl	rnrsodbcl
tngoakdmf	tngokmf
dmfvhgkago	dvhgkago
ghkswkrkatl	ghwkrkatl
rhrmqqlffk	rhrqqlffk
tmvhcmakzpxlddjq	tmvhcmakzpxldjq
tkatksxorwl	tkatksxowl
eorntjqn	eorntqn
dlTeksmswjsakddlqsl	dlTksmswjsakddqsl
dlfqntlfldjf	dlfqntfldjf
xldlstbdjfjstm	ldlstbdjfstm
alrnrdusqkd	alrnrdusqkd
rudwpruddud	rudwpruddud
qjqdnjsrudao	qjqdnjsruao
dmlskrvhrcnrth	dmlskrvrcnth
qhdksanswp	qhdksaswp
zpdldlTl	zpldlTl
gpwlvjsemtkdjq	gpwlvjsetkdjq
ektksqjqdlseoflwja	ektsqjqdlseofwja
dusthrgkfkr	dusthrgkfr
dhlqntkdghkd	dhlntkghkd
eogoddPchs	eogodchs
wlaudrudwod	wlaudrudwd
cornjstltmxpa	cornstltmxa
gudxodlamfhwoan	gudxodlamhwoan
skgPdbsTl	skgdbsTl
wldnjsduqn	wldnjsduqn
dnjftmxmflwjsjf	dnjftmxmflwjjf
gkstoarnrdjwjsansrydbr	gkstoarnrdjjsansydbr
eltmzjqjfltkdldjstmcosjf	eltmzjqjfltkdldjstmcsjf
emfdmlrkrquf	emfdmlrruf
wkrlwntlrcnlemrtlsxkrrPdir	wkrlwntlrcnlemrtlsxkrrPdr
rpdlatmvkt	pdlatvkt
djqanvmfhtptm	djanvmfhtptm
cjsdjrdnjssmfdjskT	cjsdjrdnjssmfdjskT
rmarlfufdnjswn	marlfufdjswn
qkdthdtjqltm	qkdtdtjqltm
dhlghksdmsgodemd	dhlghsdmsgdemd
ghkswjrghkanf	gkswjrghkanf
wowjdthstlf	wowjdthsf
wpwnvoszhfldkqhffld	wpwnvoszhfldkqhffd
cprkawltn	cpkawltn
skwdkwlrhqus	swdkwlrhus
rkdwpwldtnqkddks	kdwpwldtqkddks
tjadbthworltnfroqkf	tjadbthworltnroqkf
dhkswjsxhdgkq	dkwjsxhdgkq
tjryqlfeld	jryqfeld
tmfjdnsrk	mfjnsrk
xnwkwjdcor	xnwkwdcor
qotjejrkdska	qotjejrkska
rhfemstbwm	rhfemstbwm
gjdydgodkRkqrp	gjdydgodkRkrp
rkwjdvhrfurcnqkd	rkwjdvhrfurcnqkd
gkrtnfghkfehd	krtnfghkfed
djflsayfmf	djfsafmf
akdlslcl	akdslcl
qnfvusEoans	qnfsEoans
wjstprjfo	jstprfo
rhkeoakdtkd	rhkeoadtkd
wkcprltnf	kcprlnf
rhqkftodgn	hqkftdgn
xhdtlsthffntus	xhdtlstffntus
rndlqqneka	rdlqqneka
dudghkepqnl	dudghepqnl
gkdntmrkarbf	kdntmrkrbf
wldurrltnfgurtls	wldurrltfgrtls
tjswjsghktk	tsjsghktk
skaausvkcnfthwkd	skaausvkcnfthwkd
tjsrjqkdwl	tjsrjqkdwl
dltmqjrm	ltqjrm
zkemqnfqjq	zkmqnfqjq
duddjqdnlgja	dudjqdnlgja
wjdtlaghkghf	wjtlaghkghf
shddjqrltnf	shddjqrtnf
clagogksmsrjt	clagokmsrjt
rhfvmvjxld	rfvmvjxld
skfksglruftmd	skfksglruftmd
ehrehqkranfrhks	ehrehqkanfrhks
ghkfehdeksdnl	ghkfehdeksdnl
tjdnfdusxhd	tjdnfduxhd
ryeochdwkd	ryechdwkd
rjatkghkfehd	ratkghfehd
qnekagodirPdir	qnekagodirPdir
qkrmekemdmf	qkrmekemdmf
dlemsEkfdl	dlemsEkfdl
zmfpcmaj	zmfcmaj
gkftnehdlTek	gkftnehdlTek
thaormadbdwlwja	thaoradbdwlwja
gksekrhtjrgkr	gksekrhtjgkr
dkvdptjwlrwkd	dkvdptjwlrwd
tjddlstkdlxm	tjddlstkdlxm
akdmfvPtn	kdmvPtn
eoqnfrnrrktksdjqekswl	eoqfrnrrkksdjqekswl
ckdlfhapekf	kdlfapekf
sjanzjtj	sjanzjtj
wjdqneowjscjdtk	jdqneowscjdtk
tnfkrdustjf	tnfrdustjf
ghdcjsrnrehdbwlrhksfltkanth	ghdcjsrrehdbwlrhksfltkath
Tkddydghkwo	Tkddydghkwo
wpwngotn	wngotn
gksrnrwlflwjdqh	ksrnrwlflwjqh
xkdns434gh	xkdns43gh
woqjf2tp	wof2tp
wjdqnrhksfy	wjdqnrkfy
dlTdmaueksansaptlwltjqltm	dlTdmaueksanaptlwltjqltm
rnehrrPdir	rehrrPdir
tjdnfwldurqhsqn	tjdnfwldurqhqn
wlrtlgkfEo	wlrlgkfEo
rkaehrrlrhks	kaehrlrhks
vndanfansghk	vndafansghk
dkdlwmghfeldtmdl	dkdlwmghfeltmdl
wktkwjstl	wktkwjstl
tldptjsmstnsckf	tldptjmstnscf
djqrmfpdlem	djrmfpdlem
didgustmdgksrnrrhkgkr	didgustmdgksrrrhgkr
dlscjstkdfbr	lscjtkdfbr
alrnrskaqn	alrnrskaqn
wlsrudduwnd	srudduwnd
gudtjdehlaustjdlxmfWo	gudtjdehlaustjdlmfWo
qkesmsrhkdwndmsgod	qkemsrhkdndmsgod
wndeogkstk	wdogkstk
ehekfgksmssi	ehefgksmssi
dlTsmsqPstudnwl	dlTsmsqstudnwl
wncprnrals	wncprrals
wpqlwlqthtm	pqlwlqttm
wjfclsgkstk	wfclskstk
tprPrlfhrdmfThe	tprPrlfhrdmfThe
wkrkvnawlf	wkrkvawlf
tjfvjtmvmflddpahdls	tjvjtmvmflddpahdls
dbdmlwhdahr	dbdmlwdahr
dkskarjstjfeovy	dksarjstjfeovy
dmfdnsdudgks	dmfnsudgks
qoraktkeks	qoaktkeks
tlsrbemdfhrwhdahr	tlsrbemfhrwhdahr
wkdusghksrud	wkdusghkrud
wlwlxhdtls	wlwlxhdtls
gksqkdquddnjs	gksqkdquddns
ajswjqkdwltltjf	ajswqkdwltltjf
alsdmlthql	asdmlhql
dlstidldixm	dlstidlxm
cjqqhdnltjd	cjqhdnltjd
anfrkqusehdqns	anfrksehdqns
rkdghekdnstlffur	rkdgheknstlfur
tkdghwkrdyd	tkdgwkrdyd
dlemfwnqus	dlmfwqus
dhkchlrudfid	dhkchludfid
rPwhkdlcptjqltm	rPwhkdlcpjltm
dhkfydtksdptjtlfwhd	dhkfdtksdtjtlfwhd
xovudghkdnl	xovudghdnl
wowjdrudwpdnldnjs	wowjdrudwpdnldns
xmrfPdlqgkr	xmrfPdlqgr
rkatlvudrkrPghlr	rkatlvurkrPghlr
rnrduddlfrks	rnduddlfrks
cndcjdskaeh	cndcjdsaeh
rhdwjdrjfo	rdjdrjfo
xntlswktkf	ntlswtkf
thwodjqcp	thwodjcp
duddnjfwldur	dddnjfwldur
zhfldkajcjs	zhldkacjs
wldhzmfhs	wldhzmfhs
fkdpffldks	fkdpffldks
rnrflqwjswkzjavbxj	rnrflqwjswkzjavbxj
fosemtkrks	fsemkrks
rhdgkddnsdud	rhdgddnsdud
rkdyvmfhrmfoa	rkdvmfhrmfoa
tkrurrudrl	tkrurrdrl
Tkfthqlrkath	Tkfhlrkath
todtksqnsdi	dtksqnsdi
wjatnrudwod	watnrdwod
vmfkselsk	mfksesk
wlsksgoakf	wlsksokf
rhksrhkdruddud	rhksrhkdudud
cpqnfdlarma	cpqnfdlrma
dusrmatkdvna	dsrmatkvna
rudwodrurghk	rudworurghk
rhthrcjfehrhdeks	rhthrcjfehrdeks
rhdtmqrPghlr	htmqrPghlr
dbxhdwjsansdlsfur	dbxhdwjsansdlsfr
elwlxjfdudtkdwjwkd	elwlxjfddtkdwjwkd
whtjseoqnthr	whtseoqnthr
todahflcm	odahflcm
rnrxhdldydrPghlrqusrud	rnxhdldydrPghlrqusrud
vywjddmsahen	vywjddmsaen
rkqkdvldpfmrkfmepd	rkqkdvldfmrkfmepd
cjsdnjsWkfl	jsdjsWkfl
ekdidgkstkfPfmf	ekdidgkstkPmf
shgrhxhfhsgk	hgrhxhfhgk
ckrhksdmsrmfj	ckrhkdmsrmfj
wlqgodrhkwjd	wlqgodrhkwd
dkaghgoehr	dkaghoer
wkdausdmsehdanf	wkdausdmsehanf
qotkdtlscjd	qotkdlsjd
wpwnehdduwnd	wpwnehdduwnd
aleldjrldjq	aledjrldjq
cjdghkdgodyddhkdgmagid	cjdghkgodyddhkdgmagid
dldjeoghl	ddjeoghl
dmlwndrjfltbt	dmlwndrjfltbt
gnqhwldur	gqhwldur
gkseksmsdOrl	geksmsdOrl
tmvptuffltmxm	tmvptufftmxm
qoekdvmffjtm	qoedvmffjtm
wlausehdaus	wlausehaus
dbqnqkqdbqn	dbqnqqbqn
wpwnwndansghxpf	wpwnwdansghxpf
dufjtdltj	ufjtltj
gkfkrgksmsemd	gkfkrkssemd
doqmsbdml	doqmsdml
gosemalrtj	gsmalrtj
rhkdrhtndlreogoddjqwk	rhkdrhtndlreogoddqwk
xmrtnwjfehguadml	xmtnwjfehguadml
tkausgkfdls	tkasgkfdls
tmakxmzkemrhksfl	takxmzkemrhksfl
wldnjsdmfgown	wldnsdmfgown
qkrmekem	qkrmeem
wktjrhals	wktjrhals
whrjsdmfaksg	whrjsdmaksg
rkrndpdlfm	rkrndpdlfm
rmfjsktlfwp	rfjsktlfwp
rhksflwjsakd	rhsflwjsad
tpfptkdlxm	tpfptdlxm
tmtmfhdnjsclr	tmtfhdnjsclr
anrlwpgksguqwjd	anrlwpgsguqwjd
dlfrkadmfckwdmfj	dlfrkadfckdmfj
wkddnjsdbxhd	wkddnjsxhd
durtkcorwnd	dutkcorwnd
wlscnfgoehd	wlscnfoehd
tkwkddlanffuqkedkTek	tkwkddanffuqkedkTek
dksgrhekdid	dkgrhekid
dhsfkdlsdjqcp	dhsfkdlsdqcp
vmfkdtmqodn	mkdtmqodn
djejqkdlwjtm	djjqdlwjtm
wlehahfms	lhahfms
tntnfyfmfauswpgksek	tntfyfmfauswpgksek
rmadmsqhghk	radsqhghk
dlwndahrtna	dlwndahrtna
eotkddjqan	eotkddan
soqnghlrPrhksfl	soqnghrPrhksfl
wntlrtlwkddldhglfu	wntrtlkddldhglfu
rhfueotodaud	rfueotodaud
wpdlfwjcnrdmsgod	wpdlfcnrdmsgod
vkqtmdhzptmxmfj	vkqtmdhzptxmfj
rkadnjsrbah	rkadnsbah
tlscnrdPwjd	tlscrdPwjd
tksgkrrhdehd	tksgkrrdehd
flsptktm	sptktm
wnakfwkdtp	wnafwdtp
thdrmagkfuausdhlghkstlwkd	thdrmagkfuaudhlghkstlwkd
qustksqkseh	qustskseh
tlsrbcncjs	tsrbcnjs
tkrmfjemfdj	tkrmfjemdj
thddosjffltmxm	tddosjfftmxm
gkehfhrdbeh	gkehfhrdbeh
tncjssusehddks	tnssusehddks
rndml3ehd	rdml3ehd
dlrmqthrgl	dlrqthrgl
antjsdlsxjsptdyrma	antjsdlsxsptdyrma
soqnrjfoqlwnd	soqnrfoqlwnd
diaktlxk	diatlxk
emfdjtjfEoakek	emfdjtjfEoaek
didtlatjsdjs	didtlatsdjs
durjsdmfwhtjdgk	dursdmfwhtjdgk
todtkscpwp	otkscpwp
ehddkakfkxhs	ehdkkfkxhs
cpfpszksxm	cpfpszksxm
tlwkdqustn	lwkdqstn
fhtmdoswpffptmqjqdnjs	fhtmdoswpffptmqjdnjs
ajrdlfmfwpeo	ajrdlfmfeo
wlflwjdqhtjqltmwprhd	wlflwjdqhtjqltmwprhd
rnemfoeorhd	rnemfoeorhd
rnsalswjstks	rnsalswjstks
rjatordjqcp	rjaorjqcp
vudghktkdtntkd	vudghtkdtntkd
wjdtlsrPtmd	wdtlsrPtmd
eogksandurxnwkwlsgmdrhdtk	eogksanurxnwkwsgmdrhdtk
dnlsehdnxp	dnlsednxp
dureochlrkd	dureochlrkd
wlwlrlqks	wlwlrqks
qnsdiddbgud	qnsdiddbgud
ekscpwhdahr	ekscpwhdar
dnsehdtjstn	dnsehdtjstn
gltmxhtmxpa	gltmxtmxpa
ehlsmsrjfl	ehlsmsrjfl
gmlakddidqls	gmlakdddqls
whgudcmraus	gudcmraus
rhddksrkatl	rhdksrkatl
tkadudxhdtls	adudxhdtls
dnsgkdguqdir	dnsgkdudir
ehckrgowjd	ehckrgowjd
tjdnfelwlxjf	tjdfellxjf
rudrPfmfemfjso	rudrPfmfemfjso
emrdmlqnsqo	emrdmlqnsqo
rhkgkrthtjf	rhkgkrthjf
roakrrhddus	rokrrhdds
cordladmfdlswjd	cdladmfdlswjd
ansghkrhksrhkdtltjfrhksfltkdjqth	ansghkrhkrhkdtltjfrhksfltkdjqth
dlqrnrdmfrjqn	dlrnrdmfrjqn
gksrnrrlchrhkgkrwldnjs	ksrnrrlchrhkgkrwldjs
snsrlfdmfwkqsms	snsrlfdfwqsms
dlfrksdldyd	dlfrksdyd
aoaoehdgid	aoaoehdgid
tlscjdtjfb	tscjdtfb
gksrnrtjqltm	gksrrtjqltm
dlsrlrktn	dlsrlrtn
didwkrhksrP	didkrhsrP
ekaqodlstkarhd	ekaqodstkarhd
dldlrrhksfl	dldlrrhkfl
tlqrkstlqdlwl	tlqrkstlqdlwl
zyvkdlsostuf	zyvkdlsostf
dldjwlqkdrhdgkdwnd	dljwlqkrhdgkdwnd
dnjxjrpdlxm	dnjjrplxm
tnghkrguswkd	tnghkrgswkd
wjdcorwjqahr	wjdcrwjqhr
dpflrtmsqkrtk	dpflrtmsqkrtk
rhkdwnrudtjs	rhdwnrudts
rkqkddmfRnal	rkkddmfnal
gkrrytjstod	grrytjstod
Eofhsmsqhrwkqgk	Eofhsmsqhrwkgk
rkdskatkatjd	rkskatkatjd
ansghkrogur	ansghkogur
dksehlqslekEh	dksehlqsleEh
duwkvpstld	duwkvpstd
dlstkwkqdma	dltkwkqdma
tpfmfanffl	tpfmfafl
chdrhkfwlgnlgodhs	cdrhkwlgnlgodhs
rhkgkrgkrtnfekscp	rhkgkrgkrtnfekscp
chlekvksao	chlevksao
tlgjatjqltm	tlgjatjqtm
tkckfeksqhrrnl	tkfeksqhrrnl
dmsgoddlskzkem	dmsgoddlskem
duwktldrmf	duwktdrmf
qksehcpapdlzj	ksehcppdlzj
tmzlxmdmlqkr	tmzlxmdmlqr
rnralstodghkfcpdbrguqdml	rnrastodghkfcpdbrguqdml
ehdgotkacjr	ehgotkacjr
wjrqksgkwkd	wrqksgkwkd
tndlqdlsel	tndldlsel
rnswkdrnrrktksdjq	rnswkrnrrktksdjq
tjstnchsdmsrkftnfhr	tjstnchsdmsrkftfhr
wltks2ehdwkd	wltks2ehdwkd
rmsqhscnlwl	rmsqhcnlwl
qhdthogksmsrjtrhk	qhdtogksmsrjrhk
dlavlejstm	lalejstm
tjsrufanswp	tjsruanswp
gksrnrtkgkr	gksrntkgkr
goekdwldurdpdlfwjd	goekdwlurdpdlfwd
snqkxlarhk	sqkxlarhk
ghkrqhgksenl	ghkrqhksenl
vlfdygksrufwjd	vfdygksrfwjd
dnlgowjsrltkdyd	dlgowjsrtkdyd
dydvnaghltk	dydvaghtk
shtkanswp	stkanswp
soahffkfk	soahfkfk
ahshemfkak	hsemfkak
spxmdnjzmdjThtldpdlcm	spxmdnjzmdjThtlddlcm
dkstjdtlflq	dkstjtlflq
cjfsuxkdhfnsk	cjfsuxkdhfnsk
vmflwmaqpscj	vmflwmaqpscj
soqnxhdwp	soqnxdwp
vlgodigkseksmsrp	vloigkseksmsrp
rbauddldlfnjwu	rbaddldlfnjwu
cjdcnfdjfka	cjdcfdjfka
wndtlawldpdnlclgk	wndtlawldpdnclgk
tntorwkrdjq	tntorwkrdq
ghkfehdqjadnl	ghfehdqjdnl
wjdrbdnjfem	wjdrbdnjfem
tngorhdehd	tngordehd
zjaekrxj119	zjaekrxj119
ehddmlfmfdjedj	ehddmlffdjedj
dkxpspdhfflavlr	dkxpspdhfflavlr
rkrwhddmlghr	krwhdmlghr
wnfdlrhtkcodjq	wnfdlhtkcdjq
wjsdpsoshkTdj	wjsdpsoshkTdj
audfkdtjsql	audfkdtsql
qhdtkwhdgkq	qhdtkwhdgkq
Tlsmschkfdud	Tlsschfdud
vPdlstlrrl	vdlstlrrl
wkdbfruddud	wkdbfruddud
dptmdkdlxpzm	dptmddlxpzm
dlfqhsxkrrn	dlfqhxkrrn
rbsguddPtks	rbsddPtks
skwdkwlftn	skwdkwlftn
vhxhvmflsxj	vhxhvmfsxj
thdtkschemdgkrry	thdtkschedgkrry
djfudnsrhtemfdl	djfudnrhtemfdl
ansdPckdwkr	nsdPckdwkr
cnrkskrvhr	cnrkskvhr
didtkseogkrry	idtkseokrry
xldjemqkdl	xldjemqdl
qudtksthdwjscjfxkqtjfcl	udtksthdwscjfxkqtjfcl
tlemsldhfflavlrdlgn	tlemsldhfflavlrdlgn
dmlfltjdcjf	dmlfljdcf
vkffuqnsdid	vkfuqnsdid
tkdjqsodyd	tkdjqsodyd
ehfhrhdtkdptjdmsxhlgks	ehhrhdtkdptjdmxhlgks
qnwjstlwkd	nwjstwkd
wlqnscjqnsgn	wlqnscjqsgn
akclsxladl	akclsxadl
qkRdmfhqhsorh	qkRdmfhqhsorh
tkghldnsehddusrnthwkd	tkghldnseddusrnthwkd
wjsansroqkf	wjsansroqf
tkdvnadmfqjfu	kvnadmfqjfu
tkemfdmlwpgbrk	tkemfdmlwpgbrk
rkdnsepgbaortm	rkdnsepgbartm
qhqltmfpsemfltm	qhqltmfpsmltm
rhksdmaqhtkf	rhksmqhtkf
fhemflrptm	hmflrptm
gksmsdlaan	gksmsdlaan
cndqnrandyd	cndqnrandyd
akfndnsehdrudrl	akfndnsehdrdrl
dhlrnrthssla	dhlrnrthssa
glffldjemfkdl	glffldjfkdl
xmrtnrydbrwlsgmdqjq	xmrtnrydbrwlsgmdqq
skdhawlrgks	skdhawrgks
wjsakddlgkgid	wsakdlgkgid
gksmszofha	gksszoha
wjsfurtksdjqrlqksrlrma	jsfurtksdjqlqksrlrma
wkdirhvkf	wkdirhvkf
qorwpansghkdmldjf	qorwpasghkdmldjf
Rhcqkeclaxhd	Rhcqkecaxhd
wndemdtksghk	wndemdtksghk
clfytkdls	clytkls
vlffkepfvldkqksehcp	vlfkepfvldkqksehcp
flrmcnrrn	rmcnrrn
rnrwprmadbddusrntpsxk	rnrprmadbddusntpsxk
gksekfdudkvenrh	gksekfdudkverh
wpwnehghl	wwnehghl
emfdmsdbrhkdtjr	emfdsdbrhkdtjr
wnddjwndans	wnddjwnans
qnrkrlsmd	qnrksmd
wlqnfqhwmd	wlqfhwmd
wlqkddmsgod	wlqkddmsgod
fkdlstlspak	fklstlpak
ehorkskgodnstkdhk	ehorkskgodstkdhk
rhfemcc	rhemcc
altmxpfl	ltmxpfl
wksduanfdlskawl	wkduanfdlskawl
eogksalsrnrrhdrns	eoksalsrnrrhdrns
gksdncoRmx	gsdncoRmx
ghksrudwkdnjs	gksrudwkdns
gksrnrqnstjrrlrl	gksnrqnstrrlrl
vpfmsksehqkrktm	vpfmsksehqkrtm
quddurxmrfP	qddurxmrfP
dnjssoeocorghldml	djssoeocrghldml
whqudgmltkwkd	whqudgmlkwkd
wlswjdgkschlrkdwkfh	wlswjdgkschlrkdwkfh
ansghkfmfaksemfdj	nsghkfmfakemfdj
ehdlqqldyd	edlqqldyd
dnjsahrtkdxo	dnjsatkdxo
tkdghkssmdfur	tdghkssmfur
xhdghkeksdnl	xdghkesdnl
dksdmfrlghlr	dsdfrlghlr
tlftkrlrksehddks	tftkrlrksehddks
wnxorrhdrks	norrhdrks
dltkdcjstjs	ltkdcjsts
glrktldlclzldur	lrtldlclzldur
ghskarhthr	ghskrhthr
ckadutlscjd	ckdutlscjd
gmltodwktn	gmltdwktn
fhajrducls	fhajrducls
dmfshsdmlgk	dmfshsdmgk
tmxkrhkdgkr	tmxkrkdkr
ckdflqcnlwlans	ckdflqcnlwlans
rudwpxmrrngusdks	rudwpxmrrngsdks
gkfkrdmfdlfwjdqnqns	gkfrdmfdlfwjdqnqns
wjsrnrcnrrneoghl	wjsrnrcnrneoghl
wjrcnldirtjd	wjrcdirtjd
sbdpsxlzlaghdrk	bdpsxlzaghdrk
gkqqudrPghlr	gkqqdrPglr
gkwlaksskctjs	gkwlassctjs
ghlrPtjfclalc	ghlrtjfclalc
dlscnftkxo	dlscnftkxo
cjdtksanffid	cjdtksanffd
rpdlxmdnp	rpdlxmdnp
qnekdguadml	qndguadml
tkdfhrghxpf	kdfhghxpf
xpfktmxpzmshffjwl	xpfktmxpzmshffwl
rldjqdusrmawpeh	rldjqusmawpeh
tprPfmfshffkrp	trPfmfshffkrp
coaqjdhzptmxm	oaqdhzptmxm
cjswjdzmfpdls	cjswdzmfpdls
rltnfdlwjsryfbtpsxj	rtnfdlwjsryfbtpsxj
qjqwjdrmsfh	qjwjdrmsfh
ehlsekauguseotkd	ehlsekaugseotkd
rkqnfrksmd	rkqnfrkd
qkdldhqpscjrldjqwldnjstpsxj	qkdldhqpscjrldjqwldnjstpsxj
rlfmadbcnf	rlmadbcnf
zhfldkgkdlxpr	zfldkgkdlxpr
gksrkdtnrPwldur	gksrkdtnrPwldr
dudskadlfqh	ddkadlfqh
rhqnfchdfla	rhqfchdla
cnfvksqneks	cnfvkqneks
tlatktmdwls	tlatktmdws
audtlagjrjTrnaksdy	audtlagjjTrnaksdy
skdltmxmfptm	kdtmxmfptm
zpdldptm	zpdlptm
tnqorauddp	tnqorauddp
rhfemakstkrtm	rhfemakstkrtm
rmfhdnpfwjswk	rmfhdnpfjswk
cjfqurqneo	cjfqurqeo
smffutodtks	smffutdts
gksaldufflsrltnf	gksalufflsrltnf
aharkqtEkdzhd	aarkqtEkdzhd
tlrlfmfshgcl	tlrlffshgcl
skatjddmlfb	skajddmlfb
dbwlsrhksrhkd	dbsrhksrhkd
wndwjwidtjd	wndwjdtjd
qkfvydlgn	qkfvydgn
tjswjsdidh	jsjsdidh
xovudtleo	vudtleo
dhlrhkrwhwlr	dhlrhrwhwlr
rjstjfdmldk	rjstfdmldk
dlsrksqhrwpghltk	dlsrsqhrwpghltk
rygkqwkddosk	rygkwkddosk
rudwpxhdrPwkfy	rudwpxdrPkfy
ekffjtjsanf	ekffjtjsaf
ehddlfwjavh	ehddfwjavh
ruddndlqjswn	rudndlqjswn
ekffjqnwhr	ekffqnwhr
qnstkstlzlsmfkwlsEka	qnstkstlzlsmfkwlsEka
rnsdlsdutjd	rnsdlsdtjd
worPchdtn	wrPchdtn
tlfwhddkehd	lfwhddkhd
cpdbrtkdjq	cprtkdjq
rlqkstltjfrhdtk	rlktltjfrhdtk
zhemqnsgkfekwndwjqthr	zhemnsgkfekwndwjqthr
gksrnrwjdqhqhghtncnfwlsgmd	gksrnrwjdqhqhghtcnfwlsgmd
dkzbxprqksehcp	dkzbxprqksehcp
rkadkapclrl	rkakapcrl
ghksaorhkwjd	ghkaorhkwjd
wjsdydrnwkd	wjsdydrnwkd
wpwntlcjd	wpwntlcd
tkanrlrl	tkanrlrl
vlxkfkdnsem	vlxkfkdnsem
tlvdmsrjtdms	tlvmsrjtds
vktksdlfks	vkkdlfks
ansdidgorud	asdidgorud
dhtkddydrlwk	dhtkddydrwk
dosltmxhs	dosltmxs
tkdhldltk1dls	tkdldlk1dls
ehdansfhxjfl	ehdansfhxjfl
ryxhdqhwh	yxhdqhwh
dusrlgosoT	dusrlgosoT
ekslsmszjavbxj	eslsmszjavbxj
qpxpfkdqusghtk	qpxpdqusghtk
rkrwhdwhghl	rrwhdwhghl
qkseoeocordnl	kseoecordnl
ehdntmdgk	ehntdgk
tlrlwhwjdrnjsrh	tlrlwhwjdrnjrh
tkdrkdnsdud	tkdrkdsdud
akzmwpeh	azmwpeh
dptjehrhksgodtkd	ptjehrksgodtkd
rochldPwjd	rochlPjd
ehthaoel	hthoel
aksemsrhdehd	asemsrhdehd
tjddnjsrjstjf	tddnjsrjstjf
tkdntmzofhffk	kdntmzohffk
tjdnftkanth	tdnftkanth
qnrgkstjvhxjtm	qrgkstjvhxjtm
cnldjqqlwk	cnldqqlwk
tjqltmrlrhks	tjqltrlrhks
wlqnsthdb	wlnthdb
ausekarhkwjd	ausekarhkwjd
dlgodksrk	dgodksrk
qnrhkqkdcla	qnrhkqkdcla
cnrkrudwjd	crkrudwjd
fhRnfuwls	fhfuwls
rlarbstjqtjs	rlarbstjqtjs
wjdanswjdqh	wjdasjdqh
cjrcnrmsdua	cjrcrmsdua
dlsxjelwkdls	dlsxjelkds
xpzmsltus	xpzmstus
alstnstlsTl	alsnslsTl
rmffhqjfwhwlr	rffhqfwhwlr
ghkdlxmgpem	ghkdlxmem
qhffldduwk3dlswhd	qhffldduwk3dswd
qntksapflshfquddnjs	qntksapflshfquddns
fkdqkdxkdl	fkdqkdxkdl
wjdqhxhdtlstksdjqguqghl	wjdqhxhdtstksdjqguqghl
dydtlschemdgkrry	ydtlschemdgkrry
rktmdjqwhd	rktmdjqd
tpqjqrowjddpqksdud	tpqjqrowjddpqksdud
chrhkrmsan	chrhkrman
zksnwhdahr	zksnwhdahr
Ekfmsshtkguq	Efmsshtkguq
tlatkeotkd	latkeotd
rjenaughkdtjd	rjenaugkdtd
dldjakfus	dlakfus
Qoshgdmftn	Qoshgdmftn
wodlfalseks	wodlfalses
tkdlsdpdj	klsdpdj
aodlqgksdhlghk	aodlqgdhlghk
dlepdhffmrl	dlepdffrl
qlsrhsxkfcnf	qlsrhsxkfcnf
rudwprydbrwkfy	rdwprydbrwkfy
vPwlrufwjd	vPlruwjd
tlfwlrgksgn	lfwlrksgn
tjdrhkwldur	tjdrhkwldr
dlcjscnftls	dljscntls
qpscjzhfldkqpscj	qpscjzhfdkqpscj
todghkfcpdbrqnsdi	todghkfpdbrqnsdi
thrgytjdrudrndyd	thrgytjrudrndyd
qnrtjdusqkd	qrtjdsqkd
cndwntprPantnfcnrwpcnwls	cdwntprPantnfcnwpcnwls
eogkswjsansrjstjf	eogkswjsansrjsf
dnjsdpskrckfqkedkT	dnjsdpskrckfqkedT
rudwptjdwkdfbfdlwlsksgo	udwptjdwkdfbfdwlsksgo
tnwjdchemd	tnwjdhed
dudghkqormq	dudghkomq
tjdrhdeoghl	jdhdeoghl
cothtksdjq	cothtsdjq
dmfryaygl	dmfraygl
rjwlttlsghk	rjlttlghk
emdtkswhRl	emtkswhRl
gkrheocnf	gkheocf
xlaehrmaapekf	xlaehraapekf
rkaehrdlgk	rkaehrdlgk
rladhkstjqTl	ladkstjqTl
rladlrwlsrl	rlalrwlrl
zoavlddydvna	zoavlddydva
