wjdrkdlsaor	wjdkdlsaor
wkqwlrhkdrh	wkqwrhkdh
whtpqneka	wtpqneka
dhglfudbgo	dhglfdgo
qhfnspdh	qhfspdh
wjtrkfrlacl	wjtrkrlal
tkatjdghkwo	tktjdghko
wkehdckrhddjqguqehdwhgkq	wkehdckhddjqguqehdwhgkq
djqthemfdlsmf	jqthemfdlsmf
flghrhksrhkd	flghrhkhkd
whdgkqqhrwlghlrhks	whdgkqhrwlghlrhks
rnralsdlaeo	rnralsdleo
qkrekfskan	krekfskan
dmaqksrPdir	dmaqksPdir
qksdlghlckd	qksdlghlkd
rkwkdrlrks	kwkdrlrks
alswnxntk	alswnntk
gkqslekchlwhd	kqslekchlwhd
rlawngusrlwk	rlawngusrwk
gkfkrqkdgid	gkfkrqkdid
dbtkdwmdwkgn	dbkdwmdwkgn
xhdghksodur	xhdhksodur
ghksdbfwjdcor	ghksdbfwjdcor
tkavhxpzm	tkvhpzm
ahxjtmakxm	ahxjtakm
tltmxparkaflguqghl	tltmxparkflguqgl
Eoansdpgodhl	Eandpgodhl
wltlreoruf	wltlreouf
qlcjfrmathrwn	qlcjfrmahrwn
xhdwmddmlgkr	xhwmdmlgkr
rldjqqldyd	rldjqqlyd
ehtksdjqan	etksdjqn
durtlrjxahtmq	dutlrjxahtmq
fhalddlfks	fhaldlks
qkddjtneks	qkddjneks
vustjdrnrwkd	vustjdnrwkd
anffiddldb	nffiddldb
gjrktlscjd	grktlsjd
rhdtldkqls	rhtlkqls
wjsrnrdjsfhs	wjsrnrdjsfhs
tjehwndrnr	tjehndrnr
cptlsdjqan	cplsdjqan
chqheksrP	chqhksrP
rlwlrjstjf	rwlrjsjf
qntlagodhkTdm	ntlagodhkTdm
dhlghkdPrma	hlghkdPrma
shtnpdlwls	snpdlwls
rkdgkanfwlf	rkkanfwlf
gksrnrduwkvmfhrhfvmguqghl	gksrnrduwvmhrhfvmguqghl
fmfEjqkecl	fmjqkecl
dlstkqorud	lstkqorud
sofurksmsemd	sourksmsemd
wkdsotprbs	wksotpbs
rmqducprProvus	rmqduprProvus
akzptdlsdpdlqmffj	akzpdlsdplqmffj
qkseodufhs	qkeoduhs
dmfhdlfrhks	dhdlfrhks
eotkdvnaahr	etkdvnaahr
qntksrnejrwn	ntksrnejrwn
dmlghrqnqns	dlghrqnqns
tntlqsusrks	tntlqusrks
qnekddldlr	qnekdldlr
tksdjqrltnf	ksdjqrltnf
rltnfgurtlstpsxj	rltnurtlstpsxj
eoehdquddnjs	eohdquddnjs
wjdqhwnrnjs	wjhwnrnjs
vhrxkswpwh	vhrxkwph
vhrqkfwlrwjs	vhrqkflrwjs
rytnemfdmlshf	rytnemfmlshf
shsusrnjsdlrqhgh	shsusrnjsdlrqhh
toddjqdmfRnfurkf	todjqdmfnfurkf
vjsemrmfnq	vjsermnq
akdaudrlrks	akdaudrlks
wkrmaskwwka	wrmaskwwka
rmsangkejsghltk	rmsangkjsghltk
dlsxjsptqodzm	dlsxjsptodzm
dlfqnqksqkf	dlfqnqkskf
rnstkqjqdnjs	rnstqjdnjs
xkwlrltmxks	xkwrltmxks
wjsekdfltkdlxmfghf	wjsekdfltkdlxmfhf
qnvnarldjq	qnvnaldjq
dlTsmstlso	dlTmstlso
rlsmdeogkrwkd	rlsmeogkrkd
rhksrhkddnldnjs	hksrhkdnldnjs
wpgksgoddnl	pgksgoddnl
rjatordlghkfrl	jatordlghkfrl
vkfrhdskswkd	vkrhdkswkd
xhdwkddlswk	xhdwkddlswk
cowjasodur	cowjasodur
gkqdml29qn	gkqdml29qn
wjsdjwkqdl	wjsjwkqdl
dlfmfqhrh	dlfmfhrh
skantwhrkr	kantwhrkr
govlqjtm	ovlqjtm
tjswlsrmadbdrlqjqdmfhanwkdgk	tjswlsrmadbdlqjqdmfhanwkdgk
dbfjqwnddkd	dbjqwnddkd
zofhffkdlskwn	zfhffdlskwn
fpwjwnxorrhdrks	fpjwnxorrhdrks
ruddudgurtlsdpswls	rududgurtlsdpwls
rkrwhddkswjs	rkrwhdkswjs
rydbrqhsqn	rydbrqhsn
rjtdmfhqhsms	rjtmfhqhsms
aorwngkswks	aorwngkwks
rydbrgbwlr	rybrgbwlr
dldjrkftndlT	dldjrkftnlT
tkatjdwjswkelwlxjf	tkatjwjswklwlxjf
tkcothrkr	tkcothkr
roffjfldptjduffls	rofjfdptjduffls
rlawptkfy	rlawptkfy
dmfdmlalgk	dmdmlalk
wlansdlstlrtltmxpa	wlansdlslrtltmxpa
qkddjwjsfir	qkdjjsfir
ghkrwjdgoshg	ghkrwjdgohg
guswltkdghkd	guswtkdghkd
rudwodrhkwjd	rudwodrkwjd
skxkskTdmaudlsms	sxkskTdmaudlms
duwkxkrrn	duwxkrrn
ekszkswltn	ekszkswtn
tkackdvmfkwkqlfeldqptmxm	tkckdvmfkwqlfeldqptmxm
rhltksrnscjd	rhltksnscjd
rhdrmqworo	rhrmqoro
ehzbajsxm	ezbajxm
dptjwkwn	dptjkwn
ansjwusofls	ansjwusols
dugodrPdir	dugoPdir
emfdjtjsshgn	emfjtjsshgn
cjsehrywnddkd	cjsehrywndkd
eofbrghldeks	efbrhldeks
dnfltkwnwhgkq	dnfltkwnwhkq
qnrgkscpwp	qngkscwp
wmdtkswkrdjq	wmtkwkrdjq
qustlsgksmsepgksahrt	qutlsgsmsepgksahrt
tkdjqwjsfirdm	tkdjqwjsirdm
Ektjdirtp	Ektjdirtp
xhdghktltmxpa	xhdghktlmxpa
gkswkrjawjdsmdfur	gkswkrjwjdsmfur
dnthddPtnf	nthddPtnf
wlrwjqwhekf	wlwjqwhekf
tmdflfmfrjenjTtmqsl	tmdlfmfrjenjTtmqsl
elwlxjfaleldjekswl	elwlxjfaleljekswl
dlstkarhdtk	dlskarhdtk
rhksflqnsdi	rhksflqnsi
wjdekdaudqn	wjekaudqn
ehrrkadPqkd	hrrkadPqkd
duwkqorn	duworn
rlaTlrkdl	laTlrkdl
rhkrcndgheowjstjqn	rhkndgheowjstjqn
wpwkrgoqntksdktldks	wpwkrgoqntksdktlks
dlTsmsrnaowkrma	dlTsmsrnaowma
vudrbssowo	vudbssowo
worhwktks	orhwktks
guseovpdlsxm	gueopdlsxm
ruddusaneo	ruusaneo
rudrPtkdxo	rurPtkdxo
vusdlthro	vusdltro
wlqnstmdhkvmanswp	wlqnstmhkvmanswp
rhrmqwpvna	rhrmqwna
enlttlaqnwhr	enltlanwhr
sbtmtkqjqwpwjd	sbtmtkqjwwjd
wjdrmawhwjsan	wjdrmawhwjn
fkdntbvp	kdntbvp
rkftnfhrrjtpwl	rkftnfhrrjtpwl
dkfxkflan	dkxkfan
dkfmwpsxh	dkfmpsxh
wjsskashddjq	wjsskashdjq
qncofmftmdrP	qncofmtmrP
ansghkdudtkd	anshkdudtkd
xkgoddlcp	xkgoddlp
eodhldltk	eodhldlk
rhrordjqcp	rhrodjqcp
ekfdhfmarmrwkd	ekfdhfmrmrwkd
fhcjscjsgl	fhjscjsgl
dlfthsdlqnwhrgowls	dlthsdlqnwhgowls
wnxordmstjdnf	wnxodmstjdnf
rmsrjfhtka	rmjfhtka
dnswjsausgj	dnswjsaugj
wmdwkfmfdnlgo	wmwkfmfnlgo
dhqxhaowlr	dhqxhowlr
dnlrlfmfakwrh	dnrlfmfakrh
alsthrakdmfcnwlswnsql	alsthrakdmfcnwlswnsl
wjsrnrduddjdndqus	wjsrnrdudddndqus
emfdprpdidqls	mfdprpdidqls
skadnjswldur	skadnjsldur
dlTsmsfhdif	dlmsfhdif
rlaTlrkwnwkd	rlTlrkwnkd
ckwdkrksmsrhkwjd	ckwdkrksmsrhkwjd
dPtksrbah	dPtksrbah
durqoduftkdxorkrkf	duqduftkdxorkrkf
xnwkwjrrma	xnwkjrrma
tmzkdnxm	tmkdnxm
rkdwhdrnrlwk	rkdwhdrnrk
eowjsguqwjd	eowjsuqwjd
tjdvnawjsekf	tjdvnajsekf
ckddjqchrl	ckddjchrl
tkawjdwndn	tkwjdwnn
tlsehdrhddjq	tlsehdrhdjq
qhrrnqldyd	qhrrqldyd
gkdlxprdmswnrkdkswjd	gdlxpdmswnrkdkswjd
dnjtldxjseogkr	dnjtldxjseokr
qhghwhcl	qhwhcl
zhsptdnjfem	zhspdnjfm
rmarkdwpghk	rmrkdwpghk
dlaskdlfqhsqntjf	dlkdlfqhsqntjf
dbqordbTl	dbqordbTl
tkdydgodh	tkdydgh
dbaudgodks	dbaudgoks
gudtkdjqxlawkd	udtkdjqxlawkd
gmlfhdofkr	mlfhdokr
tpdlqtpcnfruftks	tdlqtpcnfuftks
dnfuroqhd	dnfuroqhd
ehdcndgkch	ehdcndgkch
wnddyalsthr	wndylsthr
dPwjddlrks	dPwjddlks
tkdghkddmsdlemf	tkdghkddmsdlmf
rmflsfkqpf	rmflsfkpf
dnwlswhdgkqrjstjf	dwlswhdgkrjstjf
fmfdlxkfgkrj	fmfdlxkfkrj
wjdtkdcnfrms	wjdtkdcnfms
wktlsrkadmfrkwrh	wktlsrkadmfkwrh
cjdsusdlsrn	cjsusdlsn
thrduvksaogk	thruvksaogk
dhthdrnrwpqkdldhgkrtnfeoghl	dhthdrnwpqkdldhgkrtnfeohl
ckfidwmdwjd	ckfidwmdjd
tjsrudandur	tjudandur
eoanstlwkd	eonstlwkd
xodjskwlswntkqja	xodjsklswntkqja
wjdqnwhdgkq	wjdqnwhdkq
ckdflqwkans	ckdlqwkans
rnrwpguqfurdmsgod	rnrwpuqfurdmsgod
dnfldmsgodruddud	dfldmsgodruddud
dhgn3tl20qns	dgn3tl20qns
tprP22dnl	tpP22dnl
eoaksdlfqhs	eaksdlqhs
qhrhksxhfhrgo	qhrhksxhhrgo
wlsksgoqpdlwlddbslqjtldkemduwk	wlsksgopdlwlddbslqjtldkemduwk
wkdrlxorqodnsthdrPdir	wkdrlorqodnsthdrPdir
wjsqnrehghl	jsqnrehghl
wnalsvusdlrtltjf	wnalsvudlrltjf
aleldjvmffpdldj9	leldjvmffpdldj9
tlsdydqlfeld	lsdydqlfeld
tlsdlfqhstksdjq	tlsdlfqhstksdjq
xotjddlshxprdnjfem	xotjddlshxpdjfem
qhrhksckdrhghkwo	qhrksckdrhghkwo
rhdrhfmfghkrdlsgksenl	rhdrhmfghkrdlsgksenl
dksgrhdlTdmsk	dksgrhdlTdmk
ekdlsoalr	kdlsoalr
rlaehtnfTldlswl	rlaehtnldlswl
qkfrnfrhkwjd	qkfrnfrhkwjd
rkwksmsrjt	rkwksmsrjt
threhqkdtn	threhqkdn
dlswowjsfir	dlswojsfir
rnjsdlrgidtkd	rnjsdlrgikd
tlsrhksehdeo	tlrhkehdeo
dlTsmsrhsrud	dlTsmshsrud
tltmxpawpwh	ttmxpawph
qordjqthffntus	qordjqthfntus
andyddPtnf	andyddPtnf
vkfkgrpqhdl	vkfkrpqhdl
gksmswndrnrcp	gksmswnrnrcp
qnfrytktkd	qnrytktkd
qldydrnwh	qldydrh
wkdtpwjsghks	wkdtpwjghks
wkdtnwldur	wkdtnldur
thfrhqkdldhapelzkf	thfrhqkdldapezkf
tlffurehrkwrh	tlfurehrkwrh
dmsgodehdrudwlwja	dmsgodehdrudlwja
thskandhkqks	thskandkqks
cnscjsqnfryqkdthd	cnscjqnfryqkdhd
xhdrPwkrdjq	xhdrwkrjq
qnfqjqdjdjqgoddnl	qnqjqdjdjqgodnl
qotkdcordlaqhgja	qotkdcordlqhja
eoqnrcjqqh	eoqnrcjh
emddmfhghksruddhdua	emddmfhgksruddhdua
ekffjtkdtmd	ekffjtkdtmd
gkcjswjdghk	gcjswjghk
wkawjdtkdyd	wkawjdkdyd
tjsrjdlgn	tjjdlgn
rnwhdjqan	rnwhdjqan
djrwlcnsgid	djrwlcnsid
dlfdjsqksrn	dldjsqksn
thsusemfdmlaowkdwkdth	hsusemfdmlaowkdwkdth
gkqnrlrhks	gqnrlrks
gksrnrrnrdkrguqghl	gksrnrrndkguqghl
wjdrlrhdco	wjdlrhdco
smsguseotkdtjs	smsguseotkdjs
wpqkdrhdtk	wqkdhdtk
aorudajsl	aorudjsl
ekatndlwjs	ekatndlwjs
whdahremfrhkwn	whdhremfrhkwn
zkemeocnf	zkemeonf
tnfuqghkfehd	tnfughkfhd
cnldjqwnsql	ldjqwnsql
endkshdhk	endkhdhk
zkemruadyd	zkeruadyd
emfdmsekth	emdmsekh
dusqkddmldnjs	usqkddmldnjs
qkfptdmfchcjdgo	kfptdmfchcjdgo
whdjqdjwkd	whjqdjwkd
wmdtldirqkf	wmdtirqkf
tlalsgkrry	tllsgkrry
wkehdwnans	wkhdwnans
dhvltmxpf4cmd401gh	dhvltmpf4cmd401gh
rudwprhksrP	ruwprhksP
tjehtjdwkd	tjehjdwkd
wlwornjswjdtkdghldml	wlwrjswjdtkdghldml
alwmghvkdlsostufrmfnq	alwmghvklsostufrmfnq
rksghdjqan	rksghdjqan
apdlfzmffjq	pdlfzmffjq
rhkddurthrkr	rkddurthrkr
shddirwpvna	shddirpvna
tkdptjchltjdghd	tdptjchtjdghd
duftkrlsua	duftrlsua
wldurquddnjs	wlduquddjs
dhkghwkdfyd	dhghkdfyd
aorkrwldnjs	arkrldnjs
xhddlfdnsehd	xhddlfdnsehd
diekddmldnjs	diekdmldnjs
cjflqkdqjq	cjflqkdjq
aneksxnrl	aneksxnl
dptjsmswjdtkd	dtsmswjdtkd
rudrlrhksfka	rudrhksfka
gksrufprmfla	gksrfprfla
anfrkdusehd	anfrdushd
ekaqodOrl	ekaqodOrl
wpwnehdutls	wpwehdutls
vhrfurtjzmf	vhrurtjzmf
todrhrfldkv	todrhrfldkv
eoaksrhfvmtkdvna	eoakshfvmtkdvna
gksmlqkfka	gkslqkfka
dlckwdkTdj	dckwdkTj
tnwldkrghk	twlkrghk
rntjdehlscpwjd	rntjdehlscpjd
vlffmagudxo	vlffmaudxo
dhlrnrtjstn	dhnrtjstn
gksmsepehalvlfgks	gksmspehalvlfgks
rkddnjswldur	rkddnjswldur
altnftprP	ltnftprP
rhdgkrtksdjqekswl	rhgkrtksjqekswl
vowjsxntn	vowjsxnn
todtksqkswkd	odtksqkswkd
zjstjfxjsem	zjstjxjsm
rltnfguqfur	rltnfguqur
dpsdptmrjscnrtjfrP	dpdpmrjscnrtjfrP
skdkrkrm	skkrkrm
tmxlrmflcm	txlrmfcm
skatjdeksdnjs	skatjdeksdnjs
voddlclrl	voddlclrl
ryxhdrhksfusqjqrbdnlqks	ryxhrhksfuqjqrbdnlqks
eoxhdfudrhdqhtntjr	eoxhdudrhdqhtntjr
wkwjsrjahf	wwjsrjhf
dlsfurdmfcjftn	lsfurdmfcjftn
wnrkstlsgh	wrkstlgh
toakdmfrmarhdkv	oakdmfrmarhdkv
eostmeoghl	eostmeohl
tjdrhkrhksfus	tjdrhkrksfus
dlfqntmdth	dlqnmdth
dnpdjwjdvnatkdydahqja	dnpdjwjdvnatkdyaqja
dpguqwhgksek	dguqwgksek
qlTlfkdls	lTlfkdls
shddjqrlqksrhdtk	shddjqrlksrhdtk
dusrmrwpwhwlr	dusmrwpwhwlr
wntlrdlsjan	wntlrdljan
tjddnjswnxorgkfqn	tjddnjswnxorgkfqn
cprufrmador	cprufrmdor
duaksrkak	duksrkak
tkagoeofla	tkagoofla
qntksansghkghlrhks	qntksansgkghlrhks
cjstkdnsehd	jstkdnsehd
dksgsmsekrnrsotnvlfwjstjdcjf	dksgsmsekrnrotnvlfwjstjdcjf
qhdlsmsdlehdxhdtls	hdlsmsdlehdxhdtls
xmfpszmsms	xmfpszmsms
qicptmffkvm	qictmfkvm
wldur18ro	wdur18o
zhtmekrtlwkdemdfhr	zhtmektlwkdmdfhr
eoghlwlrgn	eoghlwlgn
wlqwndrkafl	wlqwndkafl
rudrlrkRmxsks	rudrlkRmxsks
dmsgodgkqqud	dmgogkqqud
Rmxekgsmsrmrht	Rmxkgsmsrmrht
tkdjqdmfwns	tkdjqdmwns
rmfjgrpehl	rmfjgrphl
rnrsodbcl	rnrsobcl
tngoakdmf	tgoakdmf
dmfvhgkago	dmfvhgkao
ghkswkrkatl	ghkswkrkal
rhrmqqlffk	rhrmqqlfk
tmvhcmakzpxlddjq	tmvhcmakzpxlddjq
tkatksxorwl	tktkxorwl
eorntjqn	eornjqn
dlTeksmswjsakddlqsl	dlTesmswjsakdlqsl
dlfqntlfldjf	dlfqntfldjf
xldlstbdjfjstm	xldlstbdjfjstm
alrnrdusqkd	alrnrdukd
rudwpruddud	rudwprudud
qjqdnjsrudao	qjqnjrudao
dmlskrvhrcnrth	dmlskrvhrcnrh
qhdksanswp	qhdksnswp
zpdldlTl	zpdllTl
gpwlvjsemtkdjq	gpwlvjsemtkjq
ektksqjqdlseoflwja	ektksqjqlseoflwja
dusthrgkfkr	dusthrkfkr
dhlqntkdghkd	dhlqnkdghkd
eogoddPchs	egoddchs
wlaudrudwod	wlaududwod
cornjstltmxpa	corjstltmxpa
gudxodlamfhwoan	gudxodlamfwan
skgPdbsTl	kgPdbsTl
wldnjsduqn	wldnjsdun
dnjftmxmflwjsjf	dnjftmmflwjsjf
gkstoarnrdjwjsansrydbr	gkstoarnrdjwjsanrdbr
eltmzjqjfltkdldjstmcosjf	eltmzjqfltdldjstmcosjf
emfdmlrkrquf	emfmlrkrquf
wkrlwntlrcnlemrtlsxkrrPdir	wkrlwntlrcnlemrtlsxkPdir
rpdlatmvkt	rpdlmvkt
djqanvmfhtptm	djqanvmhtptm
cjsdjrdnjssmfdjskT	cjdjrdnjsmfdjskT
rmarlfufdnjswn	rmrlfufdnjwn
qkdthdtjqltm	kdthdtjqltm
dhlghksdmsgodemd	dhghksdmsodemd
ghkswjrghkanf	ghkwjrhkanf
wowjdthstlf	wowjdthslf
wpwnvoszhfldkqhffld	wpnvoszhfldkqhffld
cprkawltn	cprkawltn
skwdkwlrhqus	skdkwlrhqus
rkdwpwldtnqkddks	rkdwpwldtnkddks
tjadbthworltnfroqkf	tjadthworlnfroqkf
dhkswjsxhdgkq	dhkswjxhdkq
tjryqlfeld	tjryqlfeld
tmfjdnsrk	tmfjdnsrk
xnwkwjdcor	xnwkwjdor
qotjejrkdska	qotjejrkdska
rhfemstbwm	rhfmstbwm
gjdydgodkRkqrp	gjdydgokRkqrp
rkwjdvhrfurcnqkd	rkjdvhrfurcnqkd
gkrtnfghkfehd	gkrnfghkfehd
djflsayfmf	djflaymf
akdlslcl	kdlslcl
qnfvusEoans	qnvusEoans
wjstprjfo	wjsprjfo
rhkeoakdtkd	rhkeokdtkd
wkcprltnf	wkcrlnf
rhqkftodgn	rhqktodn
xhdtlsthffntus	xhdtlsthfntus
rndlqqneka	rnlqqneka
dudghkepqnl	dudghkepnl
gkdntmrkarbf	gkdntmrkarbf
wldurrltnfgurtls	ldurrltnfgurtls
tjswjsghktk	tjswjsgktk
skaausvkcnfthwkd	skaausvkcnftkd
tjsrjqkdwl	tjsrjqkdl
dltmqjrm	dtqjrm
zkemqnfqjq	zkmqnfqjq
duddjqdnlgja	dujqdnlgja
wjdtlaghkghf	wjtlaghkhf
shddjqrltnf	shjqrltnf
clagogksmsrjt	lagogksmsrjt
rhfvmvjxld	rhfvjxld
skfksglruftmd	kfksglruftmd
ehrehqkranfrhks	ehrehqkranfrks
ghkfehdeksdnl	hkfehdeksdnl
tjdnfdusxhd	tjdnfdusxhd
ryeochdwkd	rochdwkd
rjatkghkfehd	rjatkgkfehd
qnekagodirPdir	qekagodirPdir
qkrmekemdmf	qkrmekemmf
dlemsEkfdl	dlemsEkfdl
zmfpcmaj	zmfcaj
gkftnehdlTek	gkftehdlTek
thaormadbdwlwja	tharmadbdwlwja
gksekrhtjrgkr	ksekrhtjrgkr
dkvdptjwlrwkd	dkdptwlrwkd
tjddlstkdlxm	tjdlstkdlxm
akdmfvPtn	kdmfvPtn
eoqnfrnrrktksdjqekswl	eonfrnrrktksdjqekswl
ckdlfhapekf	ckdlfhpekf
sjanzjtj	sjanzj
wjdqneowjscjdtk	wjdqneojscjdtk
tnfkrdustjf	tfkrdustjf
ghdcjsrnrehdbwlrhksfltkanth	ghdcjsrnehdblrhksfltkanth
Tkddydghkwo	Tkdydghko
wpwngotn	wpwngotn
gksrnrwlflwjdqh	gksrnrwllwjdqh
xkdns434gh	xkdns434h
woqjf2tp	woqjf2p
wjdqnrhksfy	wjdqnrhksy
dlTdmaueksansaptlwltjqltm	lTdmaueksansaptlwltjqltm
rnehrrPdir	rnehrrPdir
tjdnfwldurqhsqn	tjdnfwldurqhsn
wlrtlgkfEo	wlrtlgkfo
rkaehrrlrhks	rkaehrrlrks
vndanfansghk	vndnfansghk
dkdlwmghfeldtmdl	dkdwmghfeltmdl
wktkwjstl	ktkwjstl
tldptjsmstnsckf	tldptjsmstnskf
djqrmfpdlem	djqrmfplem
didgustmdgksrnrrhkgkr	didgutmdgksrnrrhkkr
dlscjstkdfbr	dlcjtkdfbr
alrnrskaqn	alrnrkaqn
wlsrudduwnd	wlsruduwnd
gudtjdehlaustjdlxmfWo	gudtjdehlaustjdxmfWo
qkesmsrhkdwndmsgod	qksmsrhkdndmsgod
wndeogkstk	wndeogksk
ehekfgksmssi	ehekfgkmssi
dlTsmsqPstudnwl	dlTmsqPstudnwl
wncprnrals	wnprnrals
wpqlwlqthtm	wpqlwlqtm
wjfclsgkstk	wjfclsgksk
tprPrlfhrdmfThe	tprPlfhrdmfThe
wkrkvnawlf	krkvnawlf
tjfvjtmvmflddpahdls	tjfvjtmvmflddpahls
dbdmlwhdahr	bdmlwhdahr
dkskarjstjfeovy	dskarjstjfovy
dmfdnsdudgks	dmfdnsudgks
qoraktkeks	qoraktkeks
tlsrbemdfhrwhdahr	tlrbmdfhrwhdahr
wkdusghksrud	wkusghksrud
wlwlxhdtls	wlwxhdls
gksqkdquddnjs	gksqkdquddjs
ajswjqkdwltltjf	ajwjqkdltltjf
alsdmlthql	aldmlhql
dlstidldixm	dlstiddxm
cjqqhdnltjd	cjqhnltjd
anfrkqusehdqns	anfkqusehdqns
rkdghekdnstlffur	rkdghkdnstlffur
tkdghwkrdyd	tkdgwkryd
dlemfwnqus	dlemfwnqus
dhkchlrudfid	dhkhlrudfid
rPwhkdlcptjqltm	rPwhdlcptjqtm
dhkfydtksdptjtlfwhd	dhkfydtksdtjtlfwhd
xovudghkdnl	xovudghdnl
wowjdrudwpdnldnjs	wojdrudwpdnldnjs
xmrfPdlqgkr	xmrfPlqgkr
rkatlvudrkrPghlr	rkatvudrkrPghlr
rnrduddlfrks	rnrduddlfks
cndcjdskaeh	cndcjdskaeh
rhdwjdrjfo	rhdwjdrjfo
xntlswktkf	ntlswktkf
thwodjqcp	thwjqcp
duddnjfwldur	dudnjfwldur
zhfldkajcjs	zhflkajcjs
wldhzmfhs	wldhmfhs
fkdpffldks	fkdpffldks
rnrflqwjswkzjavbxj	rnrflqwjswkzjavbxj
fosemtkrks	fosemtrks
rhdgkddnsdud	rhdgkdnsdud
rkdyvmfhrmfoa	kdyvmfhrmfoa
tkrurrudrl	tkrurrudl
Tkfthqlrkath	kfthqlrkath
todtksqnsdi	todtksqnsdi
wjatnrudwod	wjanrudwod
vmfkselsk	vmfkselsk
wlsksgoakf	wskgoakf
rhksrhkdruddud	rhksrkdruddud
cpqnfdlarma	cqnfdlarma
dusrmatkdvna	dusrmatkdna
rudwodrurghk	ruwodrurhk
rhthrcjfehrhdeks	rhthrcjfehhdeks
rhdtmqrPghlr	rhdtmPghlr
dbxhdwjsansdlsfur	dbxhwjansdlsfur
elwlxjfdudtkdwjwkd	elwlxjfdutkdwwkd
whtjseoqnthr	htjseoqnthr
todahflcm	odahflcm
rnrxhdldydrPghlrqusrud	rnhdldydrPghlrqusrud
vywjddmsahen	vywjddmsahen
rkqkdvldpfmrkfmepd	rkqkdvldpfmkfmepd
cjsdnjsWkfl	cjsdnjsWkl
ekdidgkstkfPfmf	ekdidgkstkfPmf
shgrhxhfhsgk	shrhxfhsgk
ckrhksdmsrmfj	ckrhksdmsrj
wlqgodrhkwjd	wlgodrhkjd
dkaghgoehr	dkahgoehr
wkdausdmsehdanf	wkdausdmshdanf
qotkdtlscjd	qotktlcjd
wpwnehdduwnd	wpwnehduwnd
aleldjrldjq	leldjrldjq
cjdghkdgodyddhkdgmagid	cjdghkdgodydhkdgmagid
dldjeoghl	dldjeohl
dmlwndrjfltbt	dmlwndjfltbt
gnqhwldur	ghwldur
gkseksmsdOrl	kseksmsdOrl
tmvptuffltmxm	tmvptuffltmm
qoekdvmffjtm	qoekdvmfjm
wlausehdaus	wlausehdus
dbqnqkqdbqn	dbqqkqdqn
wpwnwndansghxpf	wwnndansghxpf
dufjtdltj	dfjtltj
gkfkrgksmsemd	gkfkrksmsemd
doqmsbdml	domsbdml
gosemalrtj	goselrtj
rhkdrhtndlreogoddjqwk	hkdrhtndleogoddjqwk
xmrtnwjfehguadml	xmnwjfehguadml
tkausgkfdls	kausgkfdls
tmakxmzkemrhksfl	tmakxzkemhksfl
wldnjsdmfgown	wldnjsmfgown
qkrmekem	qkrmekm
wktjrhals	wktrals
whrjsdmfaksg	whrjsdmaksg
rkrndpdlfm	rkrndlfm
rmfjsktlfwp	rmfjsklfwp
rhksflwjsakd	hksflwjsakd
tpfptkdlxm	tpfptkdlm
tmtmfhdnjsclr	ttmfhdjsclr
anrlwpgksguqwjd	anrwpgksguwjd
dlfrkadmfckwdmfj	dlfrkadmfckwdmj
wkddnjsdbxhd	wkddnjsbxhd
durtkcorwnd	dutkcorwnd
wlscnfgoehd	wlcngoehd
tkwkddlanffuqkedkTek	tkwkddlanffqkekTek
dksgrhekdid	dksghekdid
dhsfkdlsdjqcp	dhsfkdldjqp
vmfkdtmqodn	vmfkdtodn
djejqkdlwjtm	djejqdlwtm
wlehahfms	wlhahfms
tntnfyfmfauswpgksek	tnnfyfmfauswpgksek
rmadmsqhghk	rmdmqhghk
dlwndahrtna	dwndahrtna
eotkddjqan	eokddjqan
soqnghlrPrhksfl	sqnglrPrhksfl
wntlrtlwkddldhglfu	wntlrtlwkdldhglfu
rhfueotodaud	hfueotodaud
wpdlfwjcnrdmsgod	wplfwjcnrdmsgod
vkqtmdhzptmxmfj	vkqtmdhzptmxmfj
rkadnjsrbah	rkanjsrbh
tlscnrdPwjd	tlscnrdPwjd
tksgkrrhdehd	tkkrrhdehd
flsptktm	flsptktm
wnakfwkdtp	wnakwkdtp
thdrmagkfuausdhlghkstlwkd	thdrmagkfuusdhlghkstlwkd
qustksqkseh	qutksqkeh
tlsrbcncjs	tlrbcncjs
tkrmfjemfdj	tkrmfjemdj
thddosjffltmxm	thddosjfltmm
gkehfhrdbeh	gkehfhdbeh
tncjssusehddks	tcjssuehddks
rndml3ehd	rnl3ehd
dlrmqthrgl	dlrmthrgl
antjsdlsxjsptdyrma	antjsdlsxjptdyrma
soqnrjfoqlwnd	soqrjfoqlnd
diaktlxk	daklxk
emfdjtjfEoakek	emdjtjfoakek
didtlatjsdjs	idtlatjsdjs
durjsdmfwhtjdgk	dujsdmfwhtjdgk
todtkscpwp	todtkscpwp
ehddkakfkxhs	ehddkakfkxhs
cpfpszksxm	cppszksxm
tlwkdqustn	tlkdqustn
fhtmdoswpffptmqjqdnjs	fhtmdoswpffptmjqdnjs
ajrdlfmfwpeo	ajrdlfmfpeo
wlflwjdqhtjqltmwprhd	wlflwjqhtjqltmprhd
rnemfoeorhd	rnemfeohd
rnsalswjstks	rnsaljstks
rjatordjqcp	rjatordjqp
vudghktkdtntkd	vudghktkdtnkd
wjdtlsrPtmd	wjdtlsPtmd
eogksandurxnwkwlsgmdrhdtk	eogksandurxnwkwlsmdrhdtk
dnlsehdnxp	dnlsehnxp
dureochlrkd	dueochlrkd
wlwlrlqks	wllrlqks
qnsdiddbgud	qnsdiddud
ekscpwhdahr	ekscpwhdhr
dnsehdtjstn	dnsehtjtn
gltmxhtmxpa	gltmxhtmpa
ehlsmsrjfl	ehlmsrjfl
gmlakddidqls	gmlakddidqls
whgudcmraus	whgudmraus
rhddksrkatl	rhdksrkatl
tkadudxhdtls	kadudxhdtls
dnsgkdguqdir	dnsgkduqdir
ehckrgowjd	ehckrowjd
tjdnfelwlxjf	tjdnelwxjf
rudrPfmfemfjso	rudrfmfemjso
emrdmlqnsqo	emdmlqnso
rhkgkrthtjf	hkgkrhtjf
roakrrhddus	roakrrhdus
cordladmfdlswjd	cordldmfdlwjd
ansghkrhksrhkdtltjfrhksfltkdjqth	ansghkrhkrhkdtltjfrhksfltkdjth
dlqrnrdmfrjqn	dlqrnrmfrjqn
gksrnrrlchrhkgkrwldnjs	gksrnrrchrkgkrwldnjs
snsrlfdmfwkqsms	nsrlfdmfwkqsms
dlfrksdldyd	dlfrksldyd
aoaoehdgid	aoaoehdid
tlscjdtjfb	tlcjdtjb
gksrnrtjqltm	gksrnrtjqm
dlsrlrktn	dlrlrtn
didwkrhksrP	idwkrhksrP
ekaqodlstkarhd	ekqodlskarhd
dldlrrhksfl	dldlrrksfl
tlqrkstlqdlwl	tlqrkslqdlwl
zyvkdlsostuf	zyvkdlsosuf
dldjwlqkdrhdgkdwnd	dldjwlqkdrhdgkdwnd
dnjxjrpdlxm	dnjxjrpdlm
tnghkrguswkd	tnghkrguwkd
wjdcorwjqahr	jdcorwjqahr
dpflrtmsqkrtk	dpfltmsqktk
rhkdwnrudtjs	hkdwnrudtjs
rkqkddmfRnal	rkqkmfRnal
gkrrytjstod	gkrytjstod
Eofhsmsqhrwkqgk	Eofsmsqhrwkqk
rkdskatkatjd	rkdskatkatjd
ansghkrogur	ansgkrogur
dksehlqslekEh	dkselqslekEh
duwkvpstld	duwvptld
dlstkwkqdma	dlstkwkqma
tpfmfanffl	tpmfanffl
chdrhkfwlgnlgodhs	chdhkfwlgnlgodhs
rhkgkrgkrtnfekscp	rhkgkgkrtnfekcp
chlekvksao	clekvksao
tlgjatjqltm	tlgjatqltm
tkckfeksqhrrnl	tkckfekshrrnl
dmsgoddlskzkem	dmsoddlskzkem
duwktldrmf	duwktldrmf
qksehcpapdlzj	qksehcapdlj
tmzlxmdmlqkr	tmzlxmdmqkr
rnralstodghkfcpdbrguqdml	rnralstodhkfcpdbrguqdml
ehdgotkacjr	hdgotkacjr
wjrqksgkwkd	wjqkgkwkd
tndlqdlsel	tndlqdlsl
rnswkdrnrrktksdjq	nswkdrnrrktksdjq
tjstnchsdmsrkftnfhr	tjsnchsdmsrkftnfhr
wltks2ehdwkd	wltks2hdwkd
rmsqhscnlwl	rmqhscnwl
qhdthogksmsrjtrhk	hdthogksmsrjtrhk
dlavlejstm	lavlejstm
tjsrufanswp	tjsufanswp
gksrnrtkgkr	gknrtkgkr
goekdwldurdpdlfwjd	goekdwldurdpdlfjd
snqkxlarhk	snkxlarhk
ghkrqhgksenl	ghkrqhgksenl
vlfdygksrufwjd	vlfygksrufwjd
dnlgowjsrltkdyd	nlgowjsltkdyd
dydvnaghltk	dydvnahltk
shtkanswp	shtkanswp
soahffkfk	shffkfk
ahshemfkak	ahshemfkk
spxmdnjzmdjThtldpdlcm	sxmdnjzmdjThtldpdlm
dkstjdtlflq	kstjdtlflq
cjfsuxkdhfnsk	cjsuxdhfnsk
vmflwmaqpscj	vflmaqpscj
soqnxhdwp	soqnxhdp
vlgodigkseksmsrp	vgodigkseksmrp
rbauddldlfnjwu	rbauddldfnwu
cjdcnfdjfka	cjdcnfdjfka
wndtlawldpdnlclgk	wndtlawlpdnlclgk
tntorwkrdjq	ntorwkrdjq
ghkfehdqjadnl	ghkfehdqjnl
wjdrbdnjfem	wjdrbnjfem
tngorhdehd	ngorhdehd
zjaekrxj119	zjekxj119
ehddmlfmfdjedj	ehddmlfmfjedj
dkxpspdhfflavlr	kxpspdhfflavlr
rkrwhddmlghr	rkrwhdmlghr
wnfdlrhtkcodjq	wnfdlrhtkodjq
wjsdpsoshkTdj	wjdpsoskTdj
audfkdtjsql	udfkdtjsql
qhdtkwhdgkq	qhdtkhdgkq
Tlsmschkfdud	Tlsmhkfdud
vPdlstlrrl	Pdlstlrrl
wkdbfruddud	wkbfruddud
dptmdkdlxpzm	dpmdkdlxpzm
dlfqhsxkrrn	dlfqhsxkrrn
rbsguddPtks	rbgudPtks
skwdkwlftn	skdwlftn
vhxhvmflsxj	vhxhmflsxj
thdtkschemdgkrry	hdtkschemdgkrry
djfudnsrhtemfdl	djfudnrhtemfdl
ansdPckdwkr	ansdPckdkr
cnrkskrvhr	cnrkkrvhr
didtkseogkrry	didkseogkrry
xldjemqkdl	xldjemqkdl
qudtksthdwjscjfxkqtjfcl	qudtksthdwjcjfxkqtjfcl
tlemsldhfflavlrdlgn	tlemslhfflavlrdlgn
dmlfltjdcjf	dmlfltjdcjf
vkffuqnsdid	vkffqnsdid
tkdjqsodyd	tkdjqsoyd
ehfhrhdtkdptjdmsxhlgks	ehfhrhdkdptjdmsxhlgks
qnwjstlwkd	qnwjstlwkd
wlqnscjqnsgn	wlqnscjnsgn
akclsxladl	kclsxladl
qkRdmfhqhsorh	qkRdmfhhsorh
tkghldnsehddusrnthwkd	tkghdnsehddusrnthkd
wjsansroqkf	wjsansrokf
tkdvnadmfqjfu	tkdvndmqjfu
tkemfdmlwpgbrk	tkemfdmlwpgbk
rkdnsepgbaortm	rdnsepgaortm
qhqltmfpsemfltm	qhqltmfpsemltm
rhksdmaqhtkf	rksdmaqhtkf
fhemflrptm	femlrptm
gksmsdlaan	gsmslaan
cndqnrandyd	ndqnrandyd
akfndnsehdrudrl	akfndnhdrudrl
dhlrnrthssla	dhlrnrhssla
glffldjemfkdl	lffldjemfkdl
xmrtnrydbrwlsgmdqjq	xmrtnrdbrwlgmdqjq
skdhawlrgks	skhawlrgks
wjsakddlgkgid	wjsakddlkgid
gksmszofha	gksmzfha
wjsfurtksdjqrlqksrlrma	wjsfurtksdjqrlqksrlrma
wkdirhvkf	wdrhvkf
qorwpansghkdmldjf	qorwpansghkdmljf
Rhcqkeclaxhd	Rhcqklaxhd
wndemdtksghk	wndemtksgk
clfytkdls	cfytdls
vlffkepfvldkqksehcp	vlffkepfvldkksehcp
flrmcnrrn	frmcnrn
rnrwprmadbddusrntpsxk	rnwprmdbddusrntpsxk
gksekfdudkvenrh	ksekfdudkvenrh
wpwnehghl	wpwnehl
emfdmsdbrhkdtjr	emfdmsdbrkdtjr
wnddjwndans	wnjwndans
qnrkrlsmd	nrkrlsmd
wlqnfqhwmd	wqnqhwmd
wlqkddmsgod	wlqkdmsgod
fkdlstlspak	fkdlstlpak
ehorkskgodnstkdhk	ehorskgodnskdhk
rhfemcc	rhmcc
altmxpfl	altmpfl
wksduanfdlskawl	wksdanflskawl
eogksalsrnrrhdrns	eogksalsrnrrhrns
gksdncoRmx	gksdncoRmx
ghksrudwkdnjs	ghksudwkdnjs
gksrnrqnstjrrlrl	gksrnrqnstjrrlrl
vpfmsksehqkrktm	pfmsksehqkrktm
quddurxmrfP	qudurxmfP
dnjssoeocorghldml	njssoeocorghldml
whqudgmltkwkd	whqudgltkwkd
wlswjdgkschlrkdwkfh	wlswjgksclrkdwkfh
ansghkfmfaksemfdj	nsghkfmfaksemfdj
ehdlqqldyd	ehdlqqyd
dnjsahrtkdxo	njsahrtkdxo
tkdghkssmdfur	tkdgkssmdfur
xhdghkeksdnl	xhdgheksdnl
dksdmfrlghlr	dksdmflghlr
tlftkrlrksehddks	lftkrlrksehddks
wnxorrhdrks	wnxorrhrks
dltkdcjstjs	dtkdjstjs
glrktldlclzldur	glrktllclzldur
ghskarhthr	hskarhthr
ckadutlscjd	ckdutlcjd
gmltodwktn	gmltodwktn
fhajrducls	fhjrducls
dmfshsdmlgk	dmshsdlgk
tmxkrhkdgkr	tmkrhkdgkr
ckdflqcnlwlans	ckdflqclwlans
rudwpxmrrngusdks	rudwpxmrrnusdks
gkfkrdmfdlfwjdqnqns	gfkrdmfdlfwjdqqns
wjsrnrcnrrneoghl	wjsrnrcnrrneol
wjrcnldirtjd	wjrcnldirtjd
sbdpsxlzlaghdrk	sbdpsxlzlaghdk
gkqqudrPghlr	gkqudrPghlr
gkwlaksskctjs	kwlaksskctjs
ghlrPtjfclalc	ghlPtjfclalc
dlscnftkxo	dlscnfkxo
cjdtksanffid	cjdtksanffid
rpdlxmdnp	rpdlxmnp
qnekdguadml	qnekduadml
tkdfhrghxpf	tkfhrgxpf
xpfktmxpzmshffjwl	xpfktmxpmshffjwl
rldjqdusrmawpeh	rldjqdusrmapeh
tprPfmfshffkrp	tprPfmfshffkrp
coaqjdhzptmxm	coaqjhzptmxm
cjswjdzmfpdls	cjswjmfpdls
rltnfdlwjsryfbtpsxj	rlnfdlwjsryfbtpsxj
qjqwjdrmsfh	qjqwjrmfh
ehlsekauguseotkd	ehlsekauguseotkd
rkqnfrksmd	rknfrksmd
qkdldhqpscjrldjqwldnjstpsxj	qdldhqpscjrldjqwlnjstpsxj
rlfmadbcnf	rlfmdbnf
zhfldkgkdlxpr	zhfldkgkdlpr
gksrkdtnrPwldur	gksrkdtnrPwlur
dudskadlfqh	dudskadlfh
rhqnfchdfla	rhqnfchdfla
cnfvksqneks	cnvksneks
tlatktmdwls	tlattmdls
audtlagjrjTrnaksdy	audtlgjrjTrnaksy
skdltmxmfptm	skdltmxmptm
zpdldptm	pdldptm
tnqorauddp	tnorauddp
rhfemakstkrtm	rhfemakstkrtm
rmfhdnpfwjswk	rmfhdnpfwjswk
cjfqurqneo	cjfqurqeo
smffutodtks	smfutodtks
gksaldufflsrltnf	gkaldufflsrltnf
aharkqtEkdzhd	aharkqtEkdzhd
tlrlfmfshgcl	tllfmfshgcl
skatjddmlfb	skatjdmlfb
dbwlsrhksrhkd	dbwlsrhksrhkd
wndwjwidtjd	wndwjwidtjd
qkfvydlgn	qkfvylgn
tjswjsdidh	tjswjsdih
xovudtleo	xovudleo
dhlrhkrwhwlr	dhlrhkrwhwlr
rjstjfdmldk	rjstjfdmldk
dlsrksqhrwpghltk	dlsrksqhrwpghltk
rygkqwkddosk	rykqwkddosk
rudwpxhdrPwkfy	rudwpxhdPwkfy
ekffjtjsanf	ekfjtjsanf
ehddlfwjavh	hddlfwjavh
ruddndlqjswn	rundlqjswn
ekffjqnwhr	ekffjqhr
qnstkstlzlsmfkwlsEka	nstkstlzlsmfkwlsEka
rnsdlsdutjd	rndlsdujd
worPchdtn	worchdtn
tlfwhddkehd	tlfwhddhd
cpdbrtkdjq	cpdbtkjq
rlqkstltjfrhdtk	rlqkttjfrhdtk
zhemqnsgkfekwndwjqthr	zhemqnsgkfekwndwjqthr
gksrnrwjdqhqhghtncnfwlsgmd	gksnrwjdqhqhghtncnfwlsgmd
dkzbxprqksehcp	dzbxprqkshcp
rkadkapclrl	rkadapcrl
ghksaorhkwjd	ghksaorkwjd
wjsdydrnwkd	wjdydrnkd
wpwntlcjd	wpwntljd
tkanrlrl	tknrlrl
vlxkfkdnsem	vlxkfkdnem
tlvdmsrjtdms	tlvdmrjtdms
vktksdlfks	vktksdks
ansdidgorud	nsdidgorud
dhtkddydrlwk	dhtkddylwk
dosltmxhs	doltmxhs
tkdhldltk1dls	tkdhldltk1dls
ehdansfhxjfl	ehdansfhxjl
ryxhdqhwh	ryhdqhwh
dusrlgosoT	dusrlosoT
ekslsmszjavbxj	ekslmszjavbxj
qpxpfkdqusghtk	qpxpfkdusghtk
rkrwhdwhghl	rkrwhwghl
qkseoeocordnl	qkseoocordnl
ehdntmdgk	ehdtmdk
tlrlwhwjdrnjsrh	tlrlwhwjdnjsrh
tkdrkdnsdud	tkdkdnsdud
akzmwpeh	akzmpeh
dptjehrhksgodtkd	dptehhksgodtkd
rochldPwjd	ochldPwjd
ehthaoel	hthaoel
aksemsrhdehd	aksemshdehd
tjddnjsrjstjf	tjdnjsrjtjf
tkdntmzofhffk	tkdntmzofhfk
tjdnftkanth	jdnftkanth
qnrgkstjvhxjtm	qnrgkstjvxjtm
cnldjqqlwk	cldjqqlwk
tjqltmrlrhks	jqltmrlrhks
wlqnsthdb	wlqnthb
ausekarhkwjd	usekarhkwjd
dlgodksrk	dlgoksrk
qnrhkqkdcla	qnhkqkdcla
cnrkrudwjd	nrkrudwjd
fhRnfuwls	fhRnfwls
rlarbstjqtjs	rlarbtjtjs
wjdanswjdqh	wjanswjdh
cjrcnrmsdua	cjcnrmsua
dlsxjelwkdls	dlsxjelwkdls
xpzmsltus	xpmsltus
alstnstlsTl	alstnstlsl
rmffhqjfwhwlr	rmffhqjfwhwlr
ghkdlxmgpem	ghdlxmgpm
qhffldduwk3dlswhd	qhfflddwk3lswhd
qntksapflshfquddnjs	qntksapflshfqudnjs
fkdqkdxkdl	fkdqkdxdl
wjdqhxhdtlstksdjqguqghl	wjdqhxhdtlstksdjqguqhl
dydtlschemdgkrry	dydtlschemdgkry
rktmdjqwhd	rkmdjqwhd
tpqjqrowjddpqksdud	tpqjqrowjddpqksud
chrhkrmsan	chrhkmsan
zksnwhdahr	zkswhdhr
Ekfmsshtkguq	Ekfmsshtuq
tlatkeotkd	tlatkeokd
rjenaughkdtjd	rjnaughkdtjd
dldjakfus	dldkfus
Qoshgdmftn	Qoshgdmftn
wodlfalseks	odlfalseks
tkdlsdpdj	tkdlspdj
aodlqgksdhlghk	aodlqgksdhlgk
dlepdhffmrl	dlepdhffml
qlsrhsxkfcnf	qlsrhskfcnf
rudwprydbrwkfy	rudwprydbrwy
vPwlrufwjd	vPlrufwjd
tlfwlrgksgn	tlfwlrksgn
tjdrhkwldur	tjdhwldur
dlcjscnftls	dljscnftls
qpscjzhfldkqpscj	qpscjzhfldqpcj
todghkfcpdbrqnsdi	todhkfcpdbrqnsdi
thrgytjdrudrndyd	thrgytjdrudrnyd
qnrtjdusqkd	qnrtjduskd
cndwntprPantnfcnrwpcnwls	cndwntprPntnfcnrwpcnwls
eogkswjsansrjstjf	egkswjansrjstjf
dnjsdpskrckfqkedkT	dnjsdpskrckfqkedkT
rudwptjdwkdfbfdlwlsksgo	rudwtjdwkdfbfdllsksgo
tnwjdchemd	tnwjchemd
dudghkqormq	dudhkqormq
tjdrhdeoghl	tjdrhdeoghl
cothtksdjq	cottksjq
dmfryaygl	dmfryayl
rjwlttlsghk	rjwlttlshk
emdtkswhRl	emdtkswhRl
gkrheocnf	gheocnf
xlaehrmaapekf	xlahrmaapekf
rkaehrdlgk	rkehrdlgk
rladhkstjqTl	rlakstjqTl
rladlrwlsrl	rladlwlsrl
zoavlddydvna	zovlddydna
